-----------------------------------------------------------------------------------------------------------------------------------------------------------------------------------------------------------
-----------------------------------------------------------------------------------------------------------------------------------------------------------------------------------------------------------
-----------------------------------------------------------------------------------------------------------------------------------------------------------------------------------------------------------
-----------------------------------------------------------------------------------------------------------------------------------------------------------------------------------------------------------
-----------------------------------------------------------------------------------------------------------------------------------------------------------------------------------------------------------
--------------------------------------------------------------------------g--------------------r-----------------------------------------------------------------------------------------------------------
----------------#SSSSS-----------------------------------------SSCCCCCCCCSSSS---SSSS--SSSSSSSSSSSSS------------------------------------------------------------------------------------------##------------
----------------#-----------------------------------------------------------K-----------------------------------------------------------SSSSSS----------------TT----------------------------###------------
----------------#---------------------------------------------------------------------------------------------------------------------K-----------------------TT---------------------------####------------
---------------K#--k-#----------------------------1-------------------------------------------k-k----#---------------------------------------------------k----TT--------------------------#####------------
----------------#S@SS#---@@@@@----------------tt-----------------@SSSSSSSSSS--#C--------------CCCCCCC#--------------------------------TT---tt------------TT--CCC@------------------------######------------
--------------------------------------TT------tt-----------------------------##-------------------------------------------------------TT---tt------------TT-----------------------------#######------------
--------------------------------------TT------tt----------------------------###-------------------------------------------------------TT---tt------------TT-------------------TT-------########--------F---
---M----------------------------------TT------tt-----gg--------------------####----------#-----kk------------gg-------------kkk-------TT---tt------------TT-----r----------r--TT----g-#########--------#---
XXXXXXXXXXXXXXXXXXXXXXXXXXXXXXXTTXXXXXXXXXXXXXXXXXXXTTXXXXXX---XXXXXXXXXXXXXXXXXXXX------XXXXXXXXXXXXXXXXXXXXXXXXXXXXXXXXXXXXXXXXXXXXXXX---XX--XXXXXXXXXXXXXXXXXXX---XXXXXXXXXXXXXXXXXXXXXXXXXXXXXXXXXXXXX-
XXXXXXXXXXXXXXXXXXXXXXXXXXXXXXXTTXXXXXXXXXXXXXXXXXXXTTXXXXXX---XXXXXXXXXXXXXXXXXXXX------XXXXXXXXXXXXXXXXXXXXXXXXXXXXXXXXXXXXXXXXXXXXXXX---XX--XXXXXXXXXXXXXXXXXXX---XXXXXXXXXXXXXXXXXXXXXXXXXXXXXXXXXXXXX-