-----------------------------------------------------------------------------------------------------------------------------------------------------------------------------------------------------------------------------------------------------------------
-----------------------------------------------------------------------------------------------------------------------------------------------------------------------------------------------------------------------------------------------------------------
-----------------------------------------------------------------------------------------------------------------------------------------------------------------------------------------------------------------------------------------------------------------
-----------------------------------------------------------------------------------------------------------------------------------------------------------------------------------------------------------------------------------------------------------------
------------------------------------------------------------------------------------------------------------------------------------------------------------------------------------------TT---------------------------------------------------------------------
------------------------------------------------------------------------------------------------------------------------------------------------------------------------------------------TT---------------------------------------------------------------------
-------------------------------------------------------------------------------------------------------------------------------------------------------------------------------------2----##---------------------------------------------------------g##---------
-------------------------------------------------------------------------------------------------------------------------------------------------------------------------@--------------------------------------------------------------------------g###---------
------------------------------------------------------------------------------------------------------------------------------@--------------------------------------------------------------------------------------------------------------------g####---------
----------------------------------------------------------------oooo-----------------------------oooooo-----------------------------------------------oooo----------------------------2-----------------------------------------------K------------#####---------
----------------K------------------------ooo------------------------------------------##---------------------------------------------------ooo---------------------------C--------------------------------oo---------------------------###-----#--######---------
-------------------TT---------------------------------TT----------------K-------------###---------------------------K------------------------------------------------TT---------------------------------------#----------------------------------#######---------
-------------------TT----------------------------#----TT---------------------K--------####------------------------------------#--------------------------------------TT---#----tt-----------------#-----------#------TT-------------------------########--------F
---M---------------TT----gg---------kkk----------##---TT------kk-----------------#----#####-----TT-----##----gg-----------#---#-------k-kkk----kk----------kkk-------TTk--#----tt---r-------------#----kk-----#------TT-----r----gg------------#########--------#
XXXXXXXXXXXXXXXXXXXXXXXXXXTTXXXXTTXXXXXXXXXXX----XXX--TTXXXXXXXXXXXXXXXXXXXXXXXXXX----XXXXXX----TT------XXXXXXXXXXXXXXXXXXX---X--XXXXXXXXXXXXXXXXXXXXXXXXXXXXXXXXXXXXXXXXXX----XXXXXXXXX----------XXXXXXXXXXXXXXXXXXXXX--XXXXXXXXXXXXX--------XXXXXXXXXXXXXXXXXXX
XXXXXXXXXXXXXXXXXXXXXXXXXXTTXXXXTTXXXXXXXXXXX----XXX--TTXXXXXXXXXXXXXXXXXXXXXXXXXX----XXXXXX----TT------XXXXXXXXXXXXXXXXXXX---X--XXXXXXXXXXXXXXXXXXXXXXXXXXXXXXXXXXXXXXXXXX----XXXXXXXXX----------XXXXXXXXXXXXXXXXXXXXX--XXXXXXXXXXXXX--------XXXXXXXXXXXXXXXXXXX