----------------------------------------------------------------------------------------------------------------------------------------------------------------------------------------------------
----------------------------------------------------------------------------------------------------------------------------------------------------------------------------------------------------
----------------------------------------------------------------------------------------------------------------------------------------------------------------------------------------------------
----------------------------------------------------------------------------------------------------------------------------------------------------------------------------------------------------
----------------------------------------------------------------------------------------------------------------------------------------------------------------------------------------------------
------------------------------------------------------------------------------------------------------------------------------------------------k---------------------------------------k-----------
---------------------------------------------------------------------------1-------USS------------------SS!SSS@SSS--------SSC------------------S!S--S!S--------------------------------##-----------
--------------------------------------------------------------------------------------------------------------------------------------------------------------------------------------###-----------
-------------------------------------------------------------------------------------------------------------------------------------g#---------------------------------#-----------k####-----------
------------!--@-----------------------------------------------------------ggg----------------------------K---------------SSS-------g##---------------------------k-----#-----------#####-----------
---------!---------SSS---------TT---------------------S--------------##########---#-------------TT------SSSSSSSSSSS-----------------###--------S!S--S@S--------SCSSS----#----------######-----------
---------------------K---TT----TT-----------------TT----------------##--------#---#-------------TT---------------------------------####--------------------------K-----##---------#######-----------
-------------------------TT----TT-----------------TT--------TT-----###--------#---##------------TT--------------------------------#####--------------------------------##--------########--------F--
-M----------------K------TT---gTT--------------gggTT------k-TT----####--------#---##--gg----k---TT--------------K----------------######------k------ggg--------K---K---##-------#########--------#--
XXXXXXXXXXXXXXXXXXXXXXXXXXXXXXXXXXXXXX---XXXXXXXXXXXXXXXXXXXXXXXXXXXXX--------X---XXXXXXXXXXXXXXXXXXXXXXXXXXXXXXXXXXXXXXX----XXXXXXXXXX--XXXXXXXXXXXXXXXXXXXXXXXXXXXXXXXX---XXXXXXXXXXXXXXXXXXXXXXXX
XXXXXXXXXXXXXXXXXXXXXXXXXXXXXXXXXXXXXX---XXXXXXXXXXXXXXXXXXXXXXXXXXXXX--------X---XXXXXXXXXXXXXXXXXXXXXXXXXXXXXXXXXXXXXXX----XXXXXXXXXX--XXXXXXXXXXXXXXXXXXXXXXXXXXXXXXXX---XXXXXXXXXXXXXXXXXXXXXXXX