-------------------------------------------------------------------------------------------------------------------------------------------------------------------------------------------------------------------
-------------------------------------------------------------------------------------------------------------------------------------------------------------------------------------------------------------------
-------------------------------------------------------------------------------------------------------------------------------------------------------------------------------------------------------------------
-------------------------------------------------------------------------------------------------------------------------------------------------------------------------------------------------------------------
-------------------------------------------------------------------------------------------------------------------------------------------------------------------------------------------------------------------
-------------------------------------------------------------------------------------------------------------------------------------------------------------------------------------------------------------------
------------------------------------------------------------------------------------------------------------------------------------------------------------------------------------------------------##-----------
-----------------------------------------------------------@----------------@------------------------------------------------S-----------------------------------------oooo--------------------------###-----------
----------------------------------------------------------------------------------------------------------------------------------------------------------------------------------------------------####-----------
---------------------------------------------------------------------------------------------------------------------------------------------------------------------------------------------------#####-----------
------------------------------------------------------ooo-----------------------------------------------------------------------------------------------------------------------------------------######-----------
-----------------------------------------------------------#----------------C--------------K----------------------------------------------------------------------------TT-----------------------#######-----------
-----------------------------------------------------------#--------------#---#----------------------------------------------#------------------------------------------TT----------------------########--------F--
-M--------------k------ggg------kkk-------kk----#----------#-----k----ggg-#--k#-------------k-----------------k-------ggg----#-------k-----kkk-------kk----------kkk----TT----k---ggg------ggg-#########--------#--
XXXXXXXXXXXXXXXXXXXXXXXXXXXXXXXXXXXXXXXXXXXXXXXXXXXXXXXXXXXXXXXXXXXXXXXXXXXXXXX--XXXXXXXXXXXXXXXXXXXXXXXXXXXXXXXXXXXXXXXXX--XXX--XXXXXXXXXXXXXXXXXXXXXXXXXXXXXXXXXXXXXXXXXXXXXXXXXXXXXXXXXXXXXXXXXXXXXXXXXXXXXXXXXX
XXXXXXXXXXXXXXXXXXXXXXXXXXXXXXXXXXXXXXXXXXXXXXXXXXXXXXXXXXXXXXXXXXXXXXXXXXXXXXX--XXXXXXXXXXXXXXXXXXXXXXXXXXXXXXXXXXXXXXXXX--XXX--XXXXXXXXXXXXXXXXXXXXXXXXXXXXXXXXXXXXXXXXXXXXXXXXXXXXXXXXXXXXXXXXXXXXXXXXXXXXXXXXXX