---------------------------------------------------------------------------------------------------------------------------------------------------------------------------------------------------------------------------------
---------------------------------------------------------------------------------------------------------------------------------------------------------------------------------------------------------------------------------
---------------------------------------------------------------------------------------------------------------------------------------------------------------------------------------------------------------------------------
---------------------------------------------------------------------------------------------------------------------------------------------------------------------------------------------------------------------------------
---------------------------------------------------------------------------------------------------------------------------------------------------------------------------------------------------------------------------------
--------------------ooo---------------------------------------------------------------------------------oo-----------------------------------K-----------------------------------------------------------------------------------
----------------------------------------------SSSSS@---------------------------------------------------SSS---------------------------------SSSSSSS@-------------------------------r----------------------------------------------
-------------------------------------------------------------------------------------------------------------------------------------------------------------------------------SSSSS--------------CCSS----------------##---------
----------------B---------------------------------------------------------------------##---------------------------------------------------------------------------------------------------------------------------K-###---------
----------------b-----------------------------ooo------------------------------------###------------------SSS-----------------------------------K--------------------------------------------------------------------###---------
--------------####----------------------------SSSSSS-----------g##----------------#--###-------@@@@@-D-------------------------------------SSSSSSSS-------------------------------------------@--------------------#-###---------
-------------##------------------------TT--------------K-------###------TT------g##--###----------------------------------K---------------------------#------------------SSS---------------KK---------------------##-###---------
------------###------------------------TT---------------------#####-----TT------###--###------------------------------------B-----------TT------------#------------C@------------------------------TT-----------#-##-###--------F
-M---------####----k-----S-----------kkTT--------------------######-----TT---g-####--###-----------K------oo----------------b-ggg-------TT------------#----***-------------------gg----------------TT----------##-##-###--------#
XXXXXXXXXXXXXXXXXXXXXXXXXX---XXXXXXXXXXXXXXX--XXXXXXXXXXXXXXXXXXXXXXXXXXXXXXXXXXXXX--XXXXXXXXXXXXXXXXXXXXXXXX----XXXXXXXXXXXXXXXXXXXXXXXXXXXXXXXXXXX--XXXXXXXXXXXXXXXX-------XXXXXXXXXXXXXXXXXXX---XX--XXXXXXXXXX-XX-XXXXXXXXXXXX
XXXXXXXXXXXXXXXXXXXXXXXXXX---XXXXXXXXXXXXXXX--XXXXXXXXXXXXXXXXXXXXXXXXXXXXXXXXXXXXX--XXXXXXXXXXXXXXXXXXXXXXXX----XXXXXXXXXXXXXXXXXXXXXXXXXXXXXXXXXXX--XXXXXXXXXXXXXXXX-------XXXXXXXXXXXXXXXXXXX---XX--XXXXXXXXXX-XX-XXXXXXXXXXXX