-------------------------------------------------------------------------------------------------------------------------------------------------------------------------------------------------------------------------------------------------------------------------------------------------------------------------------------------------------------------------------------
-------------------------------------------------------------------------------------------------------------------------------------------------------------------------------------------------------------------------------------------------------------------------------------------------------------------------------------------------------------------------------------
-------------------------------------------------------------------------------------------------------------------------------------------------------------------------------------------------------------------------------------------------------------------------------------------------------------------------------------------------------------------------------------
----------------------K--------------------------------------------------------------------------------------------------------------------------------------------------------------------------------------------------------------------------------------------------------------------------------------------------------------------------------------------------------------
-------------------------------------------------------------------------------------------------------------------------------------------------------------------------------------------------------------------------------------------------------------------------------------------------------------------------------------------------------------------------------------
------------------------------------------------------------------------------------------------------oo-----------------------------------------------------------------------------------------------------------------------------------------------------------------------------------------------------------------------------------------------------------------------------
-----------------------##--------------------------------------------------------------------------------------------------------------------------SSSSCSSS------------------------------------------------------------------------------------------------------------------------------------------------------------------------------------------------------------##------------
----------------------###----------------------------------------------------------------------------------------------------------------------------------------------------------------------------------------------------------------------------------------------------------------------------------------------------------------------------------------------##------------
---------------------####--------------------------------------------------------------------------------------------------------------------------------------------------------------------------------------------------------------------------------------------------------#-----------------------------------------------------------------------------------#-##------------
---------------------####--------------------------------o---------------1--------o--------o-------------------------------------------------------------------------------------SSUSSSSS-------------------------------oo---------------------tt-------------------------------##--oo------o----o-------------------oo---oo-----------------------------------------#-##------------
-------------------#-####---!!!!-------------------------------------TT----------------TT--------TT-----------------------------------------------#----2----#------------------------------------------------------------------------------TT--tt------------------------------###---------------------------------------------------------------------------------#-#-##------------
--------------K---##-####--------------------------------------------TT----TT----------TT--------TT----------------------------------TT-----------#------K--#-------K------------------------------------------------------------------TT--TT--tt-----------------------------####---------------------------------------------------------------TT----------------#-#-##------------
-----------------###-####--------------------------------------------TT----TT----------TT--------TT---------tt-----------------------TT-----------#---------#-----------K----------------------------------#---------------------------TT--TT--tt----------------------------#####----------------------#---#------------------------------------TT---------TT---#-#-#-##--------F---
-M--------------####-####---------------------------k---------ggg----TT---kTT----------TT--------TT---ggg---tt-k----kkk---kkk--------TT------ggg--#---------#--------------------------------------------kk#----------------------ggg--TT--TT--tt-----k--ggg-----ggg------gg######--k-------------------#-k-#-----------------------k------kkk---TT---------TT---#-#-#-##--------#---
XXXXXXXXXXXXXX-XXXXXXXXXXXXXXXXXXX-XXX-X-XX-XX-XX-XXXXXXXXXXXXXXXXXXXXXXXXXXXXXXXXXXXXXXXXXXXXXXXXXXXXXXXXXXXXXXXXXXXXXXXXXXXXXXXXXXXXXXXXXXXXXXXXXXXXXXXXXXXXXXX-X-XX-X-XX-XXXXXXXXXXXXXXXXX-X-X-XXXXXXXXXXXXXXXXXXX------XXXXXXXXXX-XX--XX--XXXXXXXXXXXXXXXXXXXXXXXXXXXXXXXXXXXXXXXXXXXX---XX---XXXXXXXXXXXXXXXX-----X----XXXXXXXXXXXXXXXXXXXXXXXXXXXXXXXXXXX-X-X-X-XXXXXXXXXXXXXXX
XXXXXXXXXXXXXX-XXXXXXXXXXXXXXXXXXX-XXX-X-XX-XX-XX-XXXXXXXXXXXXXXXXXXXXXXXXXXXXXXXXXXXXXXXXXXXXXXXXXXXXXXXXXXXXXXXXXXXXXXXXXXXXXXXXXXXXXXXXXXXXXXXXXXXXXXXXXXXXXXX-X-XX-X-XX-XXXXXXXXXXXXXXXXX-X-X-XXXXXXXXXXXXXXXXXXX------XXXXXXXXXX-XX--XX--XXXXXXXXXXXXXXXXXXXXXXXXXXXXXXXXXXXXXXXXXXXX---XX---XXXXXXXXXXXXXXXX-----X----XXXXXXXXXXXXXXXXXXXXXXXXXXXXXXXXXXX-X-X-X-XXXXXXXXXXXXXXX