----------------------------------------------------------------------------------------------------------------------------------------------------------------------------------------------------------------------
----------------------------------------------------------------------------------------------------------------------------------------------------------------------------------------------------------------------
----------------------------------------------------------------------------------------------------------------------------------------------------------------------------------------------------------------------
----------------------K-----------------------------------------------------------------------------------------------------------------------------------------------------------------------------------------------
----------------------------------------------------------------------------------------------------------------------------------------------------------------------------------------------------------------------
----------------------------------------------------------------------------------------------------------------------------------------------------------------------------------------------------------------------
-----------------------##----------------------------------------------------------------------------------------------------------------------------------------------------------------------------------##---------
----------------------###----------------S1SSSSSSSSSSSSSSSSSSSSSSSSSSSSSSSS---------------------------------------------------------------------------------------------------------------------------K----##---------
---------------------####----------------------------------------------------------------------------------------------------------------------------------------------------------------------------------##---------
---------------------####---------------------------------------------------------------------------------------------B---------------------------------------------------------------g#----------------#--##---------
-------------------#-####---!!!!------------------------------------------------------------------S@---------SS------S#2--------------------------------------------------K-----------##----------------#--##---------
--------------K---##-####---------------------------K---------K--K----------SS--------------B-------------------------------B----------------------------TT---------K---------------g###----B---------#-#--##---------
-----------------###-####-----------------#-----------------------------------------B-----K-bK----------B-------------------b-----TT----K----TT----------TT-----TT-----K----B-------####----b--------##-#--##--------F
-M--------------####-####-----------------#-----------------------------------------b-------B-----------b--y------B--y-y----b-----TT---------TT----------TT-----TT----------b------#####-y--B-------###-#--##--------#
XXXXXXXXXXXXXX-XXXXXXXXXXXXXXXXXXX-XXXXXXXX-XXXX-X-XXX-XXXXXX-XXXXXXXXXXXXXXX--XXXX-XXXXXXXXXXXXXXXXXXXXXXXXXXXXXXXXXXXXXXXXXXXXXXXXXXXXX-XXXXX-X------XXXXXXXXXXXXXXXXXXXX-X---XXXXXXXXXXXXXXXXXXXXXXX-X--XXXXXXXXXXX
XXXXXXXXXXXXXX-XXXXXXXXXXXXXXXXXXX-XXXXXXXX-XXXX-X-XXX-XXXXXX-XXXXXXXXXXXXXXX--XXXX-XXXXXXXXXXXXXXXXXXXXXXXXXXXXXXXXXXXXXXXXXXXXXXXXXXXXX-XXXXX-X------XXXXXXXXXXXXXXXXXXXX-X---XXXXXXXXXXXXXXXXXXXXXXX-X--XXXXXXXXXXX