--------------------------------------------------------------------------------------------------------------------------------------------------------------------------------
--------------------------------------------------------------------------------------------------------------------------------------------------------------------------------
--------------------------------------------------------------------------------------------------------------------------------------------------------------------------------
------------------------------------------------------------------------------------------------------------------------------------------------U-------------------------------
--------------------------------------------------------------------------------------------------------------------------------------------------------------------------------
--------------------------------------------------------------------------------K---------------------------------------------------------------------------------k-------------
--------------------USS-----------------------------------------------------SSSSSS----1----------------------------------------SSSSS------------------------------##------------
--------------------------------------------------------------------------------------------------------------------------------------------------SS-------------###------------
---------------------------------------------------------B---------------------------------------------------------------------------------------------#--------####------------
---------------------------------------------------------b-------------------K--------------------------------------------------K-------------SS------##-------#####------------
--------------------------------!!!!-------------------SS#CS---------------SSSSSSS---------------------------------------------SSSSS-----------------###------######------------
-----------------K---B---------------K-B-----K---B-------------------TT---------------TT--------------TT--------------------------K---#----B--------####-----#######------------
------------B--------b-------B---------b---------b---------K-B-------TT---------------TT---------B----TT----TT-----B-----TT-----------#----b-------#####----########--------F---
-M----------b--------B-------b---------b---------B-----------b-------TT---------------TT---------b----TT-k--TT-----b-----TT-----------#----B------######---#########--------#---
XXXXXXXXXXXXXXXXXXXXXXXXXXXXXXXXXXXXXXXXXXXXXXXXXXXXXXXXXXXXXXXXXX--XXXXXXXXXXXXXXXXXXXXXXXXXXXXXXXXXXXXXXXXXXXXXXXXXXXXXXXXXXXXXXXXXXXXXXXXXXXXX-XXXXXXXXXXXXXXXXXXXXXXXXXXXXXX
XXXXXXXXXXXXXXXXXXXXXXXXXXXXXXXXXXXXXXXXXXXXXXXXXXXXXXXXXXXXXXXXXX--XXXXXXXXXXXXXXXXXXXXXXXXXXXXXXXXXXXXXXXXXXXXXXXXXXXXXXXXXXXXXXXXXXXXXXXXXXXXX-XXXXXXXXXXXXXXXXXXXXXXXXXXXXXX