--------------|----||--------------------------|||||--||---%|||-----o-|||-%-----%%-------S----------|||||%%%-||--||--|||%-----%|----------------------
--------------|----||-----------------------------||--||---|----------|||-|%%%%-|-------------------|||||||--||--||--|||-----%||----------------------
-------------------||--------------------%------------||---|----------|||-||||--|---------SSSS------|||||----||--||--|||-----||-----------------------
-------------------||---------------o-------o---------||--------------|||--|||--|----------------------------||--||--|||-%%%%|-----------o----SS------
--------------------------------------------%-----------------------------------|%%------------S-----------------||--|||-|||||------------S-S---------
--------------------------------------o---%%|-----------------------------------||--------------------------------------------------------------------
-----o------------------------------------|||o--------------------------------------------------------------------------------------------------------
--------------------------SS--------------|||%------------------oS------------------------------------------------------------------------------------
-----------------S------------------------|||-----------------------S---------------------------------------------------------------------------------
----------------S--%%------------------%%%%%|------------------------------------------------------------------o-g-----------o----%%%%%%%-------------
--------------------|g%-------------%%%||||||------------------------o------------------------------------%----%----------o--%-----|||||--------------
----------%---------|%---------------|||||||%----------------------------------------------------------------%-|-------------------|||||--------------
-----%-%%%T%%%------||---------------|||---||---------%-------------------------------------------------------%|-----%-------------|||||--------%%%%%-
%%%%--%||||||-------||---------%%%---||-----------------------------------------%---------o-------------------||-------------------|||||---------|||--
-||---||-||||-------||-------%%||----------------------%%%------------%%%%%-----------SSS-----------%%%%%%----|%%%-----------------|||||-----------|--
-||------------%%---||--------------------------%%%%%%-||--%-%%%%------|||---------------S-o---------|||||----||--%%%-%%%-------%-------------o-------
