----------------------------%%%---|--%%%%||||||------%----------------------------------%-------------------|||||--|||----|||-----------------------%%
----------------------------||---%|--||||||||||----%%|%---------------------%--------%-%---%%%%-------------|||||--|||------------------S-%----------|
-----------------------o----||----%%-|||||||||------||---------------------%|---------%|----||----%%%%%-----||||-------------------------------------|
----------------------------||----|--||||||||---------------------o---------|---------||----||---%|||--%%%%%|||--------------------------------------|
----------------------------||-------|||||------------------------%%---%%%--|---------||----||---------||||------------------------------------%%--%-|
-------------y%-------------||-------||||-----------------------%%|-----||%%|%--------|||--------------||-----------------o---------------------|%%--|
------------%%|%%%%%%%-------------------------------------------||------||-||%------------------------------------%-----------R----------------|||--|
-----%%------||||||||--%-----------------------------------------|-------||------------------------------------------------------------------%%-|||--|
-------------||||||||---%----------------------------%----------------------------------------------------------------------------------%%-%%|--|||---
----%--------||||||||-------------o------------------%-----------------------------------------------------------------------------------|%|||--|||---
-------------||||||||-----------------------------R--------------------------------------------------------------------------------------|||||--------
-----%%%-----|----------------------------------------------------------o-------------------------R-----------------------%%%-----%%%%---|------------
-----||-------------------------------------------------SSS-------%-S----------------------------------------------%%------||------||-----------------
%%%%-||------------------------------------------------------------------------------------------------o----%-------|%-----||%%-----------------------
-||--||------------------------------%---------%%--------------o---------------------------------------------%--%%%-||%%---|||------------------------
-||-------------------------%------|------%%%%%|-------------------o----------R------------------------------|%%||--|||----|||------------------------
