--------X-X----------X---------X--
-------S--X------X-----S----------
-----------------X--------------X-
---------S----X---------T-S-----XF
--------------X-X-------|----gS--#
----------------X-------XX---TX--X
------X--------X--------XX---XX---
------X-X------X-------------X----
--------------------------------!-
---------#-X------S-------------X-
----X----#-X-------------S------X-
----XS---#X-X-X-------------------
-----X---#X-X-X--------------X----
--M----X-#----------X------X---X--
XXXX---|-#----------X--X---X%--X--
XXXX-----X----------S-XX---S----S-
