--------XX----------#-X------------#-------X--X--
--------|X----------T-------X------X---------tX--
--------------------X--X----X------X--------%#---
-----------g---tX---X--X--------------------X#---
------XX---X-X-XX--------------------S--S---XX---
-------X---XX--XS----------------------------X---
------------X-----X--S--X--------------------X---
---------X---X----X-----X----------S--#----------
---------X---XX--X--------X-----X---X-T----------
----X--------XX--X-X--%---X-----X-----X----M--S--
----X--------S--X--X--X-----X--#------X----T----F
----------------X--------X--S-%X------XX--SX----X
-----|-------------------X----|X-------X---X----T
--M--X-----------%-----------------------X------S
XXXXS-----X-t----|X--%--------------|----X--gS---
XXXX------#-X--------#-X--------S---#-------X----
