---------XXXXXXX------------------------------------------#---------------S----------------o---------------------------#---------------------------------------------------#-----T--------------------------
---------XXXXXXX----------------------T-----2-------------#g-------------------!---------------------------------------#---S-----------------------------------------------#-K---T--------------------------
------------------------TK-----#------t------------------XXXXXXXXXX-#--------------------T------------------------##---#---------------------------------------------------X-----T-------------------Tt----F
------------------------T----#-#------t-----------------TXXXXXXXXXXXXXXXX--------T-------T-K--------#-------o----####--#---------------------------------------------------X-----T---k------#g---g---Tt----#
------------------------T---##-#----g-t---g-----k-----g-T-----------XXXXX--------T-----M-T---------#-#-----------####--#-----------------------------------------------------XXXXXXXXXXXXXXXXXXXXXXXXXXXXXXX
-------C--------------XXXXXXXXXXXXXXXXXXXXXXXXXXXXXXXXX-T-------------------XXXXXXXXXXXXXX------t--###-#-----T--#####-##--------g--------------------------------------------XXXXXXXXXXXXXXXXXXXXXXXXXXXXXXX
----------------#-----XXXXXXXXXXXXXXXXXXXXXXXXXXXXXXXXX-X-------------------XXXXXXXXXXXXXX-----ktg-###-#-----T--#####-##--------#K--------------------------------------------------------------------------
----------------#--T------------------------------------X-----------------------------------XXXXXXXXXXXXXXXXXXXXXXXXX-##----------------------------K---------------------#---------------------------------
--------#---#---#--T------------------------------------------------------------------------XXXXXXXXXXXXXXXXXXXXXXXXX-##--------------------------------------------------#---------------------------------
--------#---#--g#--T--------------------------------------------------------------------------------------------------XX--------g---#-------------------------------------#---------------------------------
-------##---#--##--------------------------------------------------------------------------S--------------------------XX------XXX---XXXXXXX-------XXXXXXXXX-------------o###--------------------------------
----K--##---#--##---------------------------------------------------------------------------------------------------------S---XXX---XXXXXXX--#----XXXXXXXXX--------------###--------------------------------
-------##---#S###----------------------------------------------------------------------------------------------------------------------------#-------------T-----------#-####-------o-----------------------
--M---###---X-###------------------------------------------------------------SS----K------------------------------------------------------K---K------------T--g-#------#-####-------------------------------
XXXXXXXXX--#X-###-------------------------------------------------------------------------U----------------------------------------------------------------XXXXXXXXXXXXXXXXX#-------------------------------
XXXXXXXXX--#X-###----------------------------------------------------------------------------S-------------L-----------------------------------------------XXXXXXXXXXXXXXXXX#-------------------------------
