------------------Tt----------b--TT---------------------------------------
------------------#t----------B--TT---------------------------------------
-------------------XXXXXXXXXXXXXXXXXXXX-----------------------------------
------S------------XXXXXXXXXXXXXXXXXXXX-----------------------------------
------------------------------------------------------------##------------
-----------------------------------------------------------###------------
----------------------------------------------------------####------------
-----------------------------------------------g---------#####---g--------
-----------------------------------------------TT-------######---TT-------
------------------1----------------------------TT------#######---TT-------
-------US------TT------------------------------TT-----########---TT------F
---------------TT------------------------o-----TT----#########---TT------#
---------------TT------------------------SSXXXXXXXXXXXXXXXXXXXXXXXXXXXXXXX
--M------------TT--------------------------XXXXXXXXXXXXXXXXXXXXXXXXXXXXXXX
XXXXXXXXXXXXXXXXXXX-t-----------------------------------------------------
XXXXXXXXXXXXXXXXXXXTt----------B--TT--------------------------------------
