------k--#--#-XX------X--1-------X---XTg--------------------X-tX---XX-#-------------K--X---X--T---------------------------X------X------X------
----o-X--#-X#XXXk-X---X----------X----XXX----#---X----------X-XXT-----#-#kT-------X-#--X---X-TT-----------------TX---XT---Xk---XX-@----X-------
------X--#-X#XX-X-X----X--XX-----------XXX--X#---X------------X-T----X#-gXT------XX-#kX------XTT----------------TX---XT----X---XX------X-------
---------#--#-X-X---X--X--XX-------------T--X#X---X-------------X----X#-XXTX-----X--#X------X-TT--------------MoT-----T----X--#-------XX-----S-
---------#----------X-------X-g-------X--X---#X-T-X-----S----X--X-----#-X-TX--------#X--X---X-XT--------------X-T---S-Tk----t-#-------XX---#---
----SX---#--X----X----------XXX-------X--X---X-XX------------X--------X---X--------X#-X-X-----XT-----------y-TX-T---S-XX----X-X------------#---
-----X---#--X----X---X-------XX--------------X-XX---X-----------------X---X-XX-----X--X--------T---------kX#-T--T-----X-----X-X-----------##---
---------#-----------X--X-----------------------X--XXX-----------X--------|-XX---------------o-T---------XX#XT-XX---T----------------#----##---
---------#----------@---X--------------------------X-XX----g-----X--------------------------------------XX-#TT-XX---T--------o-------g----##XTF
---------#--------------------------o------#X---------XXX--X----S-X-----------X------------T-----X-Tg---X----X------T-------------#--X----##XT|
---------#------------X--X----------X------#X----------XXX-X---#--X-----------X------------T-----X-Tt-#----X-X------T-------------#KTX----#X-TX
--------X#------------X--X-----#----X-----Cb-------------XX-X--#------------S--#-----------T----%--TtXX----X------X-T-------------#-T-----#X-XX
--------X#---#!----------------X--TM-X-----X--------------X-X--#------S--o-----k-S-----S---T-T--|--TXXX-------------X-----y-------#-T-----#--X-
--M---U-#M-X-#------X----------XX-TX-XTC---X----S---------g----#---X-----------XoX---------X-T----XTX--X------S----XXX----X-SC----#-X-S---X----
XXXXX----X-X-#------X-----------X-TX-XT-------------------%----#---X---#-------XXX-----------T----XX---X-----------X-X----X-SS----#XX-----X-o--
XXXXX----X#--#------X-------------T---X---------o--------------#----XX-#--------X-B----------T-T---X------------------------------XX-----X-----
