----X-X--------SS-X----X-----X--T------S-#-----------XX-g------------K-X-X---g-T--X-X-X---X----XX-X------------TXX------g----X-----X-X-
----X--k---!-----TX----------X-ST--*-----#------XS-----TXX-XX------X-X-X-X---#XT------X----XXU---------*-------X--------X----------X---
-------X---------T----------X--ST--X-----#---!--X---X--TXX-XX---X--X-X-----X--XT-----------XX----------X-------t--------X-------------F
-------X--X-X----X-X-X-----XX--STg-X-----#----------X--T--------X---X----o-X---X-----------------X-----X-------X-----X----2X----g-----X
----------XgX----X-X-XS----X---STXT--C---#----!--g-----X------------X-------X--X-----------------X------X-#-XX-------X-----X---#X-----X
------X----T-!X-----------X-----TXT---g--#---S-#-S-----X--X--X-----------S--X-----------X-----------X---X-X-XX------------S----#X-#----
------X----T--X-----------X---X-T----XX--#--T--X-S-X---X--X--X----X-S-X------X-k---g-#--X-----------X-----X@----S--------------X--X----
-----------X---X-X------------X-T----XX--X--T-kX---X-#X--------S--X---XS----kX-X---T-X---X-----X--X---------k-g---XT------!X---X--X-X--
---------X-X---X-X-------------SX--------X-Xt--------XX-------------------X-X--X---T-X---X-----X--X------S--X-X---XT-------X----T---X--
----k---SX--X--------XX--------SX---------gXt--k-----X-X----X--------X----X-X------XX-----#-X---------------X-X--X-T-XX--X-------------
----Xko-----X--------XM--------S-----S----#-T-XX--XXX--X----X--------X---X---------XX-----#-X--------X-----X----kX-T-XX--X-X--SXX------
----XT--k-------X-----X----XS--S--------X-#-T-XX-SXXX-------------------kX-------TX----T--#----------X----SX----T--T-g-----X----X------
-----TS-X-S-----X-!---X----X---S--X---X-X-#-X----------S----------------X-------STX----T--#---o---------X-----X-t--T-#--g--------------
--M--T--X----------------X--------X---X---#-X---X!-------------X--------X--------X-----T--X---------X---X--k--X-X--X-X--X----------S---
XXXXUT-#--X--------k-----X-------T-----X--#-----X--------------X--X--------X-X--XX---g-X--X---S-k--gX-X----X----T--X-X--X--------------
XXXX-XSX--X--------#----X-------oT-----X--#-----------XX----------X---S----X-X--t--X-X-#---X----XX-X-SX----X----TXX-----------X-----#-X
