--------------SS--------------------------K-----------------------------SS----------------|%--X------------%-----------%S-%---|---||||-X-|----%-------#-----------######y----K------#-------##---K-Kk-----
--------------S--------------------------T--o---------------------------SS----------------|-SS-------%S----------------|r-|---|---||---------o|-------X-----------XXXXXXXXXXXXXXXXXXXXXXX---XX-XXXXX#-----
--------------S--o-------SSS-------------TT----------------------------------o------------|----------------------------|%-|---|--o||----------|-------X-----------XXXXXXXXXXXXXXXXXXXXXXX---XX-XXXXX#-----
----------------------TT-----------------TT------------------------t---------%--%------------------------%--SS------o-S||-|%%-|---||-------So--%----------------------------------------------------#----F
---------------S---TT-TT-----------------TT------------------------t------------|------S---------------%-|-------------||-|||-----||---S-----%-|--S--------g----------------------------------------#----#
---------------S---TT-TT-----------------TT-------------##--*----kkt-S---k------------------------------%|%-------------|------o-------------|-|-o-------SSSS@--SS----------------------------#-----#XXXXX
---------------S--XXXXXXXXXX---XXXXXXXXXXXXXXXXXXXXXXXXXXXXXXXXXXXXXX---XX-------%--------o%------------||---------------------%------o------|-|-%-------------------K------------------------#-----#XXXXX
--------------SS--XXXXXXXXXX---XXXXXXXXXXXXXXXXXXXXXXXXXXXXXXXXXXXXXX---XX----------------%-------------||----%----------------|------%------|--%|----------------T------------------------X--#-----#-----
--------------CX------------------------------------------------------------------------%%|-XXTS--------||---------------------|----o-|-S----|--||--------K-------T------------------------X--#-----#-----
--------------SX-------------------------------------------------------------------------||-XXT---%-----||---------------------|------|---%--|---|----#--SSSSS--S-#----##--------------------##-----#-----
-------------#X-S-------------------------------------------------------------oo----oS---||o-----S--S----|-------------%------%%------|g-----|---|r---X--------------####-----------------K--##-----#-----
-------------#X---------------------------------------------------SSS----SSSS-%S---------||%-------------------S---------------|1-----|#-S---|---|XSS-X------------######--------------------##-----#-----
-------------#X--------------------------------------------------------------------------|||-----g------------------------%----|------|------|---|X----#--------g--######------------------S-##y----X-----
--M--k----y--#XSS-------------------------------------------------------o--------%-------|||----SS---------S-----------------%-|------|---o--|---------#XXXXXXXXXXX######-----------------X--##X----X-----
XXXXXXXXXXXXXXX-S---------C-----------------S-------------------------SSSoo--------------|||-------%%S----o--X-----------------|%%--%-|-g-%-----------y#XXXXXXXXXXX######-----------------X--##X----------
XXXXXXXXXXXXXXX-S--------------------------------------------SSSSS---o----------S----------|---X---|--------SX--SSS-----g------||--%|%%-X-|-------%--SS#-----------######--------------------##-----------
