----------------------------------------------------------------TTTT-------F---#------------tt#-----------------------------------####-------T--------
--------------------------------------*--g------------------k-g-TTTT-------#---#-----g--g--gtt#---k-------M-----------r-----------####----------------
--------------------------------XXXXXXXXXXXXXXXXXXXXXXXXXXXXXXXXXTXXXXXXXX-XXX-XXXXXXXXXX-XXXXXX--XXXXXXXXXXXXXXXXXXXXX--XXXXXXX--XXXX-----------K----
--------------------------------XXXXXXXXXXXXXXXXXXXXXXXXXXXXXXXXXXXXXXXXXX-XXX-XXXXXXXXXX-XXXXXX--XXXXXXXXXXXXXXXXXXXXX--XXXXXXX--XXXX---------------#
-------------------------------------------------------------------------------------------------------------------------------------------y--------##
--------------------------------------------------------------------------------------------------------------------------------------XXXXXXXXXXXXXXXX
--------------------------------------------------------------------------------------------------------------------------------------XXXXXXXXXXXXXXXX
----------o-------------------------------------------------------------------------------------------------------------------------------------------
------------------------------------------------------------------------------------------------------------------------------------------------------
-------------------------------#S---------------------------------------------------------------------------------------------------------------------
-------------TTT---------------#-SSS--------2-SSSSSS-------------------------------SSSS-----------S----------------------------------U----------------
-------TT---TTTT--------------##----------------------------------------o-----------------------------------------------------------------------------
-------TT---TTTT------------####---------------------------------------------------------------------------------------------U--------#---------------
-------TT--gTTTT--y-----gM-#####-----------------------------------T---------------------------#--------------------------------------#---------------
XXXXXXXXXXXXXXXXXXXXXXXXXXXXXXXX---------------S-----------------TTTT------------------S-----tt#-------!--------------!U-----------####-------T-------
XXXXXXXXXXXXXXXXXXXXXXXXXXXXXXXXX--------------------------------TTTT-----------#------------tt#-----------------------------------####-------T-------
