----------------------------------------------------------------------------------------------------------------------------------------------------------------------------------------------------------------------------------------------------------------------------------------------------------------------------------------------------------------------------------------------------------------
----------------------------------------------------------------------------------------o-----------------------------------------------------------------------------------------------------------------------------------------------------------------------------------------------------------------------------------------------------------------------------------------------------------------------
-----------------------------------------------------------------------------------------------------------------------------------------------------------------------------------------------------------------------------------------------------------------------------------------------------------------------------------------------------------------------------------------------------------K----
-----------------------------------------------------------------------------------------------SS---------------------------------------------------------------------------------------------------------------------------------------------------------------------------------------------------------------------------------------------------------------------------------------------------------------
---------------------------------------------------------------------------------------------o---SSS--------------------------------------------------------------------K----------------------o-----------------------------------------------------------------------------------------------------------------------------------------------------------------------SSSS--SS--------------------------K-##---
----------------------------------------------------------------------------------------#-------------------------------------------------------S--------------------------#---------R----------------------S-S------------------------------------------------------!------------------------------------------------------------------------------------------------------------------------------------###---
---------------!----------------SS------------------------------------------------------#-----------------------------------------------#--------oooo-------------------####------------------------------------S----------------------------------------------------------------------------------------------------------------------#--------TT------------------------------------------------------#####---
-----------------------------------------------------------K---------------------------##-----------t#---------------------------------T#----------------------------g######-----------------------------------------------------------------------------------------------------------------------------------------------------------##------TTT--------------------D--------------------------------######---
-------------------------------------------------------------------------------------#-##----B--t---t#-------------K---B---------------T#----------------------------#######---------------------------------k--------------------------------------------------------------------------------#-----t----#------#--------------S@----###-------TTTTt##---------------------------------o@@!!-------#---######---
--------------@--o----------------------------------kgg-----------------------ggg---##-##----b--t---t#-----------------b--------------KT#---------------------------########------------------S------t-----#CC---#----#-------!C--------T--------------------------SS@-----------------------##-TT--t-#------------------------------###-------TTTTt###----------------------t-#---------------TT--#---######---
---------------@----------------------------XXXXXXXXXXXXXXXX--XXXXXXXX----XXXXXXXXXXXX-###---B--t---t#-----------k*----B----k----------T#---------#----------------#########-------------------------t#K---#-----#----------------------TT----------TT--------------------C----------------####-TT--t-#------------------------------###---XXXXX-XXXXXXX-------------------t-t-#t--------------TT--###-######---
------------------K-------------------------XXXXXXXXXXXXXXXX--XXXXXXXX----XXXXXXXXXXXX-XXXXXXXX-XX--XXXXXXXXXXXXXXXXXXXXXXXXXXXXXXXXXXXX--------K-#---------------##########--------------------T----t#----#---###---#---B--------B-----TT----------TT---------------------B----------g----####-TT--t---------kg---------------Kg----###---XXXXX-XXXXXXX----XXXXX----------t-tg#t-----k-------kTT--##########---
----------------------------K----------------------------------------------------------XXXXXXXX-XX--XXXXXXXXXXXXXXXXXXXXXXXXXXXXXXXXXXXX----------#-------------############--------------------T---kt#----#--k###g--#---b--------b-----TT----*-----TT----gg---------------b-----XXXXXX----XXXXXXXXXX----XXXXXXXXXX--XXXXXXXXXXXXXXXXXXX--------------------XXXXX-XXXXXXXXXXXXXXXXXXXXXXXXXXXXXXXXXXXXXXXXXXXXXX
--M-----------k-------------------X-XXXXXg----------------------------------------------------------------------------------------------------XXXXXXXXXXX--XXXXXXXXXXXXXXXXXXXXXXXXXXXXXXXXXXXXXXXXXXXXXXX-XXXXXXXXTTXXXXXXXXXXXXXXXXXXXXXXXXXXXXXXXXXXXXXXXXXXXXX-XXXXXXXXXX----XXXXXX----XXXXXXXXXX----XXXXXXXXXX--XXXXXXXXXXXXXXXXXXX--------------------------XXXXXXXXXXXXXXXXXXXXXXXXXXXXXXXXXXXXXXXXXXXXXX
XXXXXXXXXXXXXXXXXXXXXXXXXXXXXXXXX-X-XXXXX-----------------------------------------------------------------------------------------------------XXXXXXXXXXX--XXXXXXXXXXXXXXXXXXXXXXXXXXXXXXXXXXXXXXXXXXXXXXX-XXXXXXXXTTXXXXXXXXXXXXXXXXXXXXXXXXXXXXXXXXXXXXXXXXXXXXX-XXXXXXXXXX-----------------------------------------------------------------------------------------------------------------------------------
XXXXXXXXXXXXXXXXXXXXXXXXXXXXXXXXX-------------------------------------------------------------------------------------------------------------------------------------------------------------------------------------------------------------------------------------------------------------------------------------------------------------------------------------------------------------------------------
