-----XXXXXXXXXXXXXXXXXXXXXXXXXXXX------------------XXXXXXXXXXXXXXXXXXXXXXXXXXXXXXXXXX-----------------XXX-
-------------------------------------------------S--------------------------------------------------------
-------------------------------------------------------------------------------------S--------------------
-------------------------------------------------S--------------------------------------------------------
--------------------------------S-------------------------------------------------------------------------
----S-----------------------------------------------------------------------------------------------------
---------------------------------------------o---------------------------------------##-K##---------------
------------------------S-------------------------------------------------------g-#####-###----S----------
-------------------------------------------------------------------------S------###########---------S-----
---------------------------------------S--------------------------------------#############---------------
---------#----------------------------------!---------------------------------#############---S--!S-------
---------#--@---------!-------oTT-----------------------------------S---------#############---------------
---------#---------------------TT---------------------------------------------#############---------------
--M------##--------------------TTX-g-----k--------------T--K----------------###############--T-----------F
XXXXXX---##-------------gg-----TTTXXXXXXXXXXXXXXXX------T------------------###########XXXXXXXXXXXXXXXXX--#
XXXXXXXXXXXXXXXXXXXXXXXXXXXXXXXXXXXXXXXXXXXXXXXXXX--XXXXXXXXXXXXXXXXXXXXXXXXXXXXXXXXXXXXXXXXXXXXXXXXXXXXXX
