--------XXXXXXXXXXX--------------------XXXXXXXXXXXXXXXXXXXX-
--------------------------------------------------XXXXXXXXX-
-----------------------!---S--------------------------------
-------------------S-------S--------------------------------
---------------------------S--------------------------------
------------------------------------------------------------
---------------------o----------------------------S---------
----------------------------------------------------g-------
--------g-------S-----------#-------------------------------
--------o--------------------------------S--------S---------
-------------------------!-----SS-#-------#-------X---------
----------------------------------#-------#---S-------------
---------------#------------------#-------#-----T-----------
--M-M--gS----B-#T-t---------XM----#--g---##-----T-----------
XXXXXXXXX----b-#T-T-XXXXXXXXXXXXXXXXXXXX-##-----T----------F
XXXXXXXXXXXXXXXXXXXXXXXXXXXX-XXXXXXXXXXXXXXXXXXXXXX--------#
