----------X-----XXXXXXXXXXXXX----------------------------T-------------------------------------------------------------------------------------------------------------K--------------------------------------XX|-----------##------TX---#XXXXXXXXXX----------k----o-||-------------------------------------
---------------------------------------------------------T-ok-----------g---------k---k------------------------------X---S-S-S-----------------------------------------------------------------------------XXXXXX---r-------##------TTXXXXXXXXXXXXXX-------S--S----%-|%-------------------------------------
---------------------------------------------------------XXXXXXX-------XXXXXXXXXXXXXXXX---------------------XXT------TXX-----SX----------------------------------------------------------------------------XXX---XXXXXXXXXXXXXXXXXXXXXXXXX----------------------X-#|-|------S-------------------------------
--------------------------------------------------------XXXXXXXX-------XXXXXXXXXXXXXXXX---------------------XXXXXXXXXXXX------X-S---S----------------------------------------------------------------------------XXXXXXXXXXXXXXXXXXXXX------------------S-------XX#|----------------------------------------
--------------------------------------------------------XX-----------------------------------------------------XXXXXXX-----------S-----------------------!---------!--------------------------------------------------------------------------------------S--X---X#%----------------------------------------
----------------------------------------------------------------------------------------------------------------------------------------@--------------------------------------------------------------------------------------------------------------------X----X|---o---S------------------------------S-
---------------------------------------------------------------------------------------------------X-2-------------------T-S-S---------------------------------------------------------------------------------------------------------------------------------S--X|---%---S--------------------------------
---------------------------------------#-----------------------------------------------------------X---------------------T----S------X--------------------------------------------------------------------------------------------------------------------------S--|-%-|-------------------------------S----
---------------#-----------------------#-----X---------------------------------------------------T--------------------------K----#---b------------XXXT-#--#--------------------------------------------------------------------------------------------------------|||-|------------------------------------
---------------#-----------------------#-----X---------------------------------------------------T--X----------------------------#---#XXXXk-------XXXXX#T-#---------------------------------------#---------------------------------------#-------------------S----|||%|--------T---------------------------
---------------#-------------------XX--#---------------------------------------------------------T--X----------------------------#-g-XTXXXXX----------X#T-#-------------k-------------------------#-------------------------K-------------#-----------------------S|-|||--------T---------------------------
---------------#T------------------XXS-#------------------------------------------------------XXXXXX------------------------g-----XX-X----XX-----------XT-#g-#--------XXXXXXXXXX---T--------------#--------------------------#------------#-----------------------S--|||------T-T---------------------------
--------------T#T--------------------X-#------------------------------------------------------XXXXXX------------------------Xk----XX-------------------XXXXXXXX-------XXXXXXXXXX---T--------------#---------S---------------o#------------#-------------------S--S---|||------T-T----------M#--------#-----F
--M---g-------T#T--T-----------------XXXXXXX----------------------------------------------------------X---------------------XX--------------------------XXXXXXX--------------------T-k#------#----#--------------------------#------------#------#-----------S--------||XXXXXXXXTXXX#XXXXXXXXXT---k--#-%----
XXXXXXXXXX--XXXXX--T-----g-y-k--------XXXXXX--------------T-------------------------------------------X-----U----------------X--o--------------------------------XXXX-------------XXXXXXXXXXXXXXXXX--------------------------##-----------#------#-----------------S--||XXXXXXXX-XXX-XXXXXXXXXXXXXXXXXX|----
XXXXXXXXXX-XXXXXXXXXXXXXXXXXXX----------------------------T------------------------------------------------------------------------------------------------------XXXX-------------XXXXXXXXXXXXXXXXX--------------%-----------##------K----#------#----------------S---||------X----------------XXXXXXXX|----
