-----X|-%-XSX-X---------------X-----X-#X-
-----T|-|-X-XS---S------X-----------X-#--
-----X-----------X------X----S--X---X-X--
-----X-----------X--g---------#-XT-T--X--
-----T---X------X---#------X-T#--X-X-----
-----X---X--%---X---#------X-X#----X-----
-----|--X---#------X#-T------T#----X-----
-----#--X-o--------X#-t------TX----------
-----Xg-------------X-X------TX----------
-----XX--X----------X-X-X----T-----------
------X--X--#---------XXX----T-#SX-------
------T--|--#---------XX----XX-T-X-X--T-F
------X-----|---------------X#-T---X--X--
--M---X-----T------------------X--S--K--T
XXXX--T----X---------XS-X------X------X-t
XXXX--T#---X-k-T-S---X--X------X-----tX%X
