-----X-XXXX---X-XXXX--XXXXXXXXXX--X-XXXF
----Xt-XX-----X-XXXX--XX----X--------#--
----XX------#--X-----------------X-X----
-----XX--X--X--T----#---X-X-X-X--XXX-X-X
------XXXX-XXTT---X-X--XX-X-X-X---X--X-X
----X--XX--X-XXX--XXXX-X---------g------
----XX#------XR----X----k-kS----XXX---#-
-----XX--X---------#----XgX-XXXXXXX--XXX
------XXXXXX-X-X-X-XX---XXX-XXXX----XXXX
----X--XX--X-X-XXXXXX----X----------X---
----X------C--#-X--------k------#-X-----
---------X-X#-#-------X--XX-X---X-X-XX-X
----Y--XXX-XX-XXXX--X-XX-XXXX---X----X-X
--M----XX-----XXXX--X--X---X------------
XXXX------------------------k-T---X-X---
XXXX--X---#X-------------XXXX-XXX-XXXXXX
