------------------------XXXXXXXXXXXXXXXXXXXXXXXXX------------------------------------------K------------------XXXXXXXXX-------------------------------------------------XXXXXXXXXXXXXXX---!-------------------------------SS----------t-2------------------------------------------S------------------XXXXXX-----#-#--------------------------T--t------S---
-------------------SSS--XXXXXXXXXXXXXXXXXXXXXXTXX-------------------------SSS---------o-----------------------XXXXXXXXX-------------------------------------------------XXXXXXXXXXXXXXX-----------------------------------------------t-----------T------#----g---------------------------------------XXXXXX-----#-#---g-------------------gk-T--tgg--#-----
-------------------SS-----------------------------------------------------------------------------------------------------------------------------------------------------------------------------------------------------------------t-----------T-----y#XXXXXXX----------------------B---S--------------------XX-XXXXXXXXXXXXXXXXXXXXXXXXXXXXXXXXXXXX-----
-----S-------------SS---------------------------------------------------------------------o--------------------------------------------------------------------------------------------------------o--------------------k-------------t-----------Tg----##XXXXXXX--k----------g--------b------------------------XX-XXXXXXXXXXXXXXXXXXXXXXXXXXXXXXXXXXXX-----
-------SS-----------S---------------------------------------------------------------------S---------K----S-T------------------------------------------------------------------------------XXXXX--------------------XXXXXXXXXXXXXXXXXXXXXXXXXXXXXXXXXXXXXXX--------XXXXXXXXXXXXXXXXXXXXXX--------------------------------------------------------------------
---------------------S--------------S-------------------------------------------------------U--------------T-------------------------------------------------------------S---------S------XXXXX--------------U--S--XXXXXXXXXXXXXXXXXXXXXXXXXXXXXXXXXXXXXXX--------XXXXXXXXXXXXXXXXXXXXXX---S----------------------------------------------------------------
----------T---------S---------------------------------------------------------------K---B------------------T---------------------------------------------------------#--------------------------------------------------------------------------------------------------------------------------------------------------------------------------------------
----------T--------SS-------------------------------------------------------------------Bg------g----------T---------S---------------------------------------K---T--------------------------------------------------------------------------------------------S--------------------------------------------------S-----------------------------S------------
-------SS-T--------SS---------------------------------K---------------------!----XXXXXXXXXXXXXXXXXXXXXXXXXXXXX--------------------------------------TT-T--------TT--------------------------------------------S-----------------------------------------------------------------------------S--------------S------------------------------------------------
----------X----------------------------------------------------------------------XXXXXXXXXXXXXXXXXXXXXXXXXXXXX--------------------------------------TT-T--------TT--------------------------S-SS--S-----------S-----------SSS-SS------------SS---S-------S-------------------------S--------%---------------------------------------------------------------
----------T--------------------------------------------------------------------------------------------------------------XXXXXXXXXXXXXXXXXXXXXXXXXXXXXXXXXXXXXXXXXXXXX-----T-----S-----------------------------------------SS------------------------------!-----S-----------------S------------------------------------------------------------------------
-----S----T------------#--------o--------------S--------------------#----------------------------------------------------XXXXXXXXXXXXXXXXXXXXXXXXXXXXXXXXXXXXXXXXXXXXX-----T------------------------------T----------------SS-----------------------------------------------So-----S-------------------------------o-------------------------------S--------
-------XXXXXXXXXXXXXXXXXX-----#-------SS-------T--XXXXXXXXXXXXXXXXXXXXX--XXXXX---------------------------------------------------------------------------------------------TT-----------------------------T----------------SSS-----------------------------------------------------------So-------------U--------B-----------------------------------------F
--M----XXXXXXXTXXXXXXXXXX----##----------------T--XXXXXXXXXXXXXXXXXXXXX--XXXXX--------S------------------------------------------------------------------------------------TT---------------------------gkT-------------------------S------S----------------------------------------------------------------#----b----------1------------------------------B
XXXXXXX---------------------B##----------------T--------------------------------------------------------------------t------------------g-----------------------------------TT-------##-------------XXXXXXXXXX--------------------------------------------------------------------------------------------####----#----------------------------------o-----XX
XXXXXXX---------------------###----------------T--------------------------------------------------------------------t--g------------------------------SS--S----------S-----TT------####------------XXXXXXXXXX---------------o--------S---------------------------------------o-------------S-------------####-----g-#--------------------------X----------XX
