-------------------------------------------------------------------------------------------SSS--S-----------------------
-------------------------------------------------------------------------------------------------S----------------------
------------------------------------------------------------------------------------------------S-------S-SS------------
------------------------------------------------------------------------------------------------------------------------
-------------------------------------------------------------------------------------S---------------S------T-----------
------------------------o--S--------%--------------------------------------------------S------------SSSS----T-----------
--------------------!--SS-------------o--------------------------------------t----g---S---------------------T-----------
----------------------S-------------------------------------------------K----t----#--------------------S----T-----------
------------------------------------------y---------------------------------Tt---T#-----S------#------------T-----------
--------------------------2---------------#---------------------------------Ttt--T#------S-----##--------XX-XXXXXXX-----
----------Co-----------SSSSS--------------#---#---------------------M-------Ttt-#T#--------#---XXX-------XX-XXXXXXX-----
----------------------------X--------XXXXXX---XXXXXXXXXXXXX-XXXXXXXXXXXXXXXXXXX-XXX--------XXXXXXX-----------------tT---
--------------------------K-T-------MXXXXXX---XXXXXXXXXXXXX-XXXXXXXXXXXXXXXXXXX-XXX--------XXXX--------------------XT--F
--M--gg---------k------k----X--XXXXXX------------------------------------------------------------------------------XT--#
XXXXXXXXXXXXXXXXXXXXXXXXXXXXX--XXXXXX------------------------------------------------------------------------------XXXXX
XXXXXXXXXXXXXXXXXXXXXXXXXXXX-------------------------------------------------------------------SSS------------------XXXX
