-----------------------------------------------------------------------------------------------------------o-o-------------------------------------------------------------------
-----------------------------------------------------------------------------------------------------------%%%-------------------------------------------------------------------
-----------------------------------------------------------------------------------------------------------|---------------------------------------------------------------------
-------------------------------------------------------------------------------------------oggg------------|---------------------------------------------------------------------
------------------------------------------------------------------------------oo---------o%%%%%%-----------|-o%--ooo-------------------------------------------------------------
-----------------------------------------------------------o-----------------------oo----%|||||-----------%|%%--%%%%%o-----------------------------------------------------------
-------------------------------------------g%%---SSooo----o-------------------------------|||||------------|||---||--%o-------oo-------------------------------------------------
-------------------------------------------#%------------------------------SSSSSS---------|||||----R-------|||---||--|%----------------------#------------------------##---------
------------------------------------------##----------S-----------------------------------|||||------SSS---|||---||--||---------------------##---------------------K-###---------
------------------------------------------##---------S------------------------------------|||||------------|||---||--||--------------------###--------oo-------------###---------
----------------------------------------#-##%%%%%--------------------r--------------------|||||------------|||---||--||--%%%%%--%%%------#####---------------------#-###---------
---------------------------------------##-##||||--------SSSS------%%%%%%%%%---------------|||||------------|||%--||--||---|||----|-------#####--------------------##-###---------
------------------------------------y-######||||-------%------%%%%||||||||---------%%%%---|||||------------||||%-||--||%--|||----|-------#####-----------------##-##-###--------F
--M-------------gg-------Sggg------#########||||---------------|||||||||||----------||----|||||------------%----%%%%%||-%-|||----|---XXXXXXXXX-----------------##-##-###--------#
XXXXXXXXXXXXXXXXXXXXXXXXXXXXXXXXXXXXXXXXXX-X||||---------------|||||||||||----------------|||||------------|-----|||-||---|||----|---XXXXXXXXX------------XXXXXXX-XX-XXXXXXXXXXXX
XXXXXXXXXXXXXXXXXXXXXXXXXXXXXXXXXXXXXXXXXX-X||||-------------------------------------------------------------------|-||---|||----|------------------------XXXXXXX-XX-XXXXXXXXXXXX
