----------------------S----X----X-S-K-X------t---------X-------%---------X-X-----t----
-------X#--%----XX--|-----#----X----X-gU-----------X-X#bXk--------------#--y-XX---%---
-----S---X---------------------X----%-------X#-----X---X--X----T-g-----X--X-----------
------XXSS---|---X-XXS-|--y--|--X--------------------XX---TX-----X---X-------X---S----
------X%------U----------X-X---------------T--|X------X---#------b------%------XTt----
------S--------------ST---X--X--T----X-------------------------X----X--C-------X#-----
----XX----X-X----------X--XX---X-S---------X---S-------X-------T-X#---g-X-X-X------M--
---------X-X-----X---XS-X-------X--S-------XX|--S--|-XXXX-X-------------#-----XS--X--F
----------X-X-------#-X---X---%--------#--X--X------------------------X---------|--X--
------X--|B-----------------------X---g----------------X--------t---T--t--Xo-----X--#-
------------------S--#---------TX---X#-------------------------X----XX-----XX---------
------|-X------------------X--X------------%----X------------------------X--X---*-----
----X------X--------------------------|-g--X-T-X----X-------X-X-#|---#--------X--X--T-
--M-----X--#-X-------X-------X----t-X--S----X------------%---------X--X#-|%---TX-X---X
XXXX------X-------X--------|X------------S---o----------------------|--------X-----X-T
XXXX---XX|----X--XX--------X-X---#-o----X-----------X----------X--K---------------X---
