--------------------------------------------------------------------------------------------------X----------------X-
------------------------------------------------------------------------K-------------------------|------------------
------------------------------------------------C--------o-------------------------------------S%-|----o---S---------
--------------------------------------S-------------------------------------S------------------%|-|----SS-S----------
------------------------------------------------------o----------------------------t-----------||o|------------------
----------------------------------------------------------T------------------------T----S------||-|-----S----#-------
---------------------------------S------------------------T-------S----------------T-----------#S-|----------S--T----
------------------1-----------------S---------------------#-----------------------tX--------------|-------------t----
-----------------------------------------------1----------S--------------S--------X#---------S----|-------------#----
----------------------------------------------------------------#-----T------------#---------S---SS-!-----------S----
--------------C---S--T----------S-------------------------------T-----t------------T-T------------S--------------@---
---------------------T-----------------------------TK---S-------#-----T---gk-------XXXXXSX---------------------------
-------------#-T-----T-----------T-----------------T-g----XXXXXXXXXXXXXXXXXXXXXXXXXXXXXX-X--------------------------F
--M----------T-T-----T-----------T-rS------------gXXXXXXXXXXXXXXXXXXXXXXXXXXXXXXXXX-----S-------o--%%---------------T
XXXXXXXXXXXXXXXTXXXXXXXXXXXXXX-XXXXXXXX-XXXXX---X-XXXXXXXX-------S---------------------------------|----%-----------T
XXXXXXXXXXXXXXX#XXXXXXXXXXXXXXSXXXXXXXX-XXXXX---X--------------------------------------------------|-------------%--X
