--------X-----XX--%-------------o---|---X----------XX---U---XX-------X----X---------%-g----#---X-
---------k--------X--X--XSX-X------X------------X------X---X-X----------X---X---!#----S---X--X-T-
---------C-KS-------XS-X------#X|X-X-------------X---#---X----------------T----X------------X---F
----|----#---#-##---|--------------T------------X--X-------T-X--------X---X--X-!-X-----X---------
--------XS----------X-X----XX-SSX------------#-----X-XX-----XX-X----S-o---S-SX----------X-------S
-------#--X------XX---XX---XX---X----XS----------X----X--#-----X-X----|S---------#------X-------X
-----------------------------------k-X-S-X--------#------X-----|---#S--X--------------|------XX-X
----------X--------------X--|---S|----XXX---T------X-X-X-|------X-X------S---|------XS--T-*--X---
-----k---X-----------X--------------|-------X------X---o--X---------X------------------X-XXX----X
----X-#-#X-XC---X--X--------------------XSX--#-------------------X----t---------X---#X---X-S-----
-------------------------X|--------X----------#X----X------X---X----X--#-o-----X--------------|--
----------X------X------------#X--------X---------------|-------o----------------X-X----X-------T
----X|-----X----S-----X----T--T--S--XXX---X-XX----------|---S--------------%X--------------K-----
--M-----X-----#-X-----X-----S@-----XX----------X-S----------#-----X---------------#X%------------
XXXX---|-------#---t|----|--X-X----X#-X---X-X---X-------TX------XXXX-S--X----X-------------o----S
XXXXX-X-|------X------------X----X--Tg--T--------------#--#X-----------X--------------#---#------
