----------------------#-|--------------X------------X-------------X--------X------X---S-------#-X--------------------X---X----X-------X---X-----X-----X---X-------------X------X---X-SX|-o--|----T--X-XX--X-------#----
-------k-------XX--S--#----X------#---XX-X--X---|X--X--------S-----------X-1------X--X-----X------X---X-g----------X#-------------T--T----X-------#-XXSX------------------------#-X-----------------X--X---#--------S--
-----X#---X--U-S--------gX-X-----S-----X-X-X|--S----X-----X--X---------#-----------g---------|-X----X--SK-|------X--%--S-S---|--------X----T----------------T--X|------XX------X-------#XX------------X--X--og---------
------#-------#-----X---X----K------#----X---------------T--X---------S------X-------|--------X---#---X---%#---S------------!----------#-----%X----------X---------------X#--X----------------------X-X-X------------T-
---------X---------X------------------X-X--X----X--X-#XX--X----------X--------------X-----X-----X--------XX------X--------X-S----------X-----X----X------X---X-t----X------------T---------#--#-T----------------S#----
----X------X-------------------XX-----------------#----#----X-X--------------#----X|-------------|----#-|------------X---------g---------X--------------X--------X-X-|----%-----X----X----|o-------------------------@-
----|-----XX--XXX--------------S--L------------X---------X-X-----X------------rg---|X-X----------------------S------------S-|----|-----X---|--------X--------#S-X-----%-----------X------S-X------T-----X--T--------X--
-------X--X-----X-----|X-o---X--X-X--X-X-----------X------#---#X----X--k------Xg---------%------X-k-X----X%------X---X------------------#X-------X-------------X--XT-------------------T--XX-----------X--#---X-|#-----
------#-X----#-------S-----#--------------X---X|--X-----------XX----X#----X--X--X-----X------#---X----------------X--------X---X-X-X---#XT-----------------#--%--X---------S--X---------------X----------------------#-
-----|-X--S---X---------TX---X-T------S--X--------X-------X-------------------XX--T----X----X#-X-SS--T--X-X--XX--S------------------------------------|-------X------S---X--|-----------X-----------------|g---S-XX--T-
------X----#---X--------X-X----X--X--------------S------XX---------#-X----S----X---#--|--T--S--S-----|--------S---X--X--|--||-X--------X---X--------X--------X------#-S---------------------S----------T-------------X-
-------X------|--------X--oXXX-#---X---X--|--|----X--g-#---X-X-----#-----------XSX---------X-------------------X--S----X-----X---X---X-------X--XS--------------------#|X--------------------------#------X---X-X------
----X------||-------X---SX--X---X----------T--X-X----------X--X-X#-X--C------|---S--X---------||--------X#----X----S------------------------X---|!---X--X--------------%---#--X---------------------------------------F
--M-----------X%---------X--S--|------X--------S-------------------X%-----X--------#--------X--------X-X--T-X-X-X-X-X-----|g-----------------------------X----------XX-T--X-X--X---S-X-|-------T-X-----X------X-------X
XXXX-----X------X-------------X-----------------|----|------X-----X-------|-----XX----X----g----X-------X----X-------X---X------X--#--XS--SX-|-----#|-------#---------------X---S--------------------X---------g-----SX
XXXX----------#---TX-----XX--------#X------M-------------X-X-X----------X---------X--X------X------|X--@---X-#-T----------------X-SX-------------------#|-#-CT-X------------------o---------|--TXX-----X---#-##t---t---
