------------------------------------------------------------------------------------------------------------------------------------------------------
------------------------------------------------------------------------------------------------------------------------------------------------------
------------------------------------------------------------------------------------------------------------------------------------------------------
------------------------------------------------------------------------------------------------------------------------------------------------------
------------------------------------------------------------------------------------------------------------------------------------------------------
-----------------------------------------------------------------------------------------------------------------------k------------------------------
-----------------------------------------------------------------------------------------------------------SSS--------S!S-S------------USSS--------SSC
--------------------------------------------------------------------------------------------------------------B---------------------------------------
-------------------------------------------------------------------------#------------------------------------b---------------------------------------
-------------------------------------------------------------------k-----#----------------------------------K-b---------------------------------------
--------------------------TT---TT----TT-------------------------SCSSS----#---------------------------------SSS#-------S!S-------------S-----TT---!!!!-
--------------------------TT---TT----TT---------------------------K-----##-------------------TT---------------------------------------------TT--------
--------------------------TT---TT----TT---------------------------------##---------B----B----TT----TT---------------------T-----------------TT--------
------------k-ggg-----ggg-TT--gTT---gTT---------------ggg-------K---K---##------y--b----b----TT-k--TT---------------k-----Tg--gg----k-ggg---TT--------
XXXXXXXXXXXXXXXXXXXXXXXXXXXXXXXXXXXXXXXXXXXX---XXXXXXXXXXXXXXXXXXXXXXXXXXX---XXXXXXXXXXXXXXXXXXXXXXXXXXXXXXXXXX-XXXXXXXXXXXXXXXXXXXXXXXXXXXXXXXXXXXXXX
XXXXXXXXXXXXXXXXXXXXXXXXXXXXXXXXXXXXXXXXXXXX---XXXXXXXXXXXXXXXXXXXXXXXXXXX---XXXXXXXXXXXXXXXXXXXXXXXXXXXXXXXXXX-XXXXXXXXXXXXXXXXXXXXXXXXXXXXXXXXXXXXXX
