------------------------XXXXXXXXXXXXXXXXXXXXXXXXXXXXXXX-------XX-----XXXXXXXXXXXXXXXXXXXXXXXXXXXXXXXXXXXXXXXXXXXXX---XXXXXXXXXX-----------------------
------------------------XXXXXXXXXXXXXXXXXXXXXXXXXXXXXXX-------X------------------------------------------------------XXXXXXXX-------------------------
------------------------------------------------------------------------------------------------------------------------------------------------------
------------------------------------------------------------------------------------------------------------------------------------------------------
---------------------------------------------------------------SS-------------------------------------------------------------------------------------
------------------------------------------------------------------------------------------------------------------------------------------------------
-------------------------------------------------------------------------------------------------------------------------------------##--------------2
-------------------y---------------------------------------------------------------------------##-----------------------------------###---------------
-----------------#SS----------------------2-----------------------S----------------------------##--------------------------2-------####---------------
----------------##--------------------------------------------------S-------------------------###---------------------------------#####---------------
-----SSS-------###--SC---------------------------------y-----------------------ooo-----------####--------------------------------######--------------2
--------------####----------------ooo------------------XSS-@!---!-------------------------TT-####----------------#--o-----------#######---------------
-------------#####---SS-------------------2-----------XX--------------------TT-----------#TT-####----------------#---------2---########--------F------
------------######-------------TT--------------------XXX-------S------------TT----------##TT-####--------F-------#-------------########--------#---y--
XXXXXXXXXXXXXXXXXX-------------TT-------------------XXXX-------S---------y--TT-------k-###TT-####--------#---y---#----------F-##XXXXXXXXXXXXXXXXXXXXXX
XXXXXXXXXXXXXXXXXX----------y--TT-------y--y-------XXXXX---SSSSSX-----XXXXXXXXXXXXXXXXXXXXXXXXXXXXXXXXXXXXXXXXXXXXX------y--X##XXXXXXXXXXXXXXXXXXXXXXX
