--------------------------XXXXXXXXXXXXXXXXXXXXXXXXXXXXXXXXXXXXXXX---XXXXXXXXX--XXXXXXXXXXXXXXXXXXX----------------------------------------------------
------------------------------------------------------------------------------------------------------------------------------------------------------
------------------------------------------------------------------------------------------------------------------------------------------------------
------------------------------------------------------------------------------------------------------------------------------------------------------
----------------------------------------------------------------------------------------------------------------------------------------------------2-
-----------------------------------------------------------------------------------------------------------S------------------------------------------
--------------------------------------------------------------------------------------------------------1---------------------------------------------
-----------------------------------------------------------------------------!!!!---------------------------------------------------------------------
-------------------------------------o-------------------------------------------------------------------------------SU-----------------------------2-
--------------@-----------------------------------------------------------------------------------------gggg-S----------TT----------------------------
-------!!------------!!!-TT---------o------------------------------------------y-------------------########SS-----------TT--TT----------#-----F-------
-------------------------TTT-------o----------------!!!!-------------------!!@SS!!!---------------##--------------------TT--TT--------kk#-----#---y--y
-------------------------TTT---------------------------------------------------------------------##-----------XXXXXXXXXXXXXXXXXXXXXXXXXXXXXXXXXXXXXXXX
-----------------y------gTTT-------------------------------------------------------------------####-----------XXXXXXXXXXXXXXXXXXXXXXXXXXXXXXXXXXXXXXXX
XXXXXXXXXXXXXXXXXXXXXXXXXXXT---------y--------y-------y-------------------------------------kkk####--------X------------------------------------------
XXXXXXXXXXXXXXXXXXXXXXXXXXXXXXXXXXXXXXXXXXXXXXXXXXXXXXXXXXXXXXXXXX---XXXXXXXXX--XXXXXXXXXXXXXXXXXXX--------X------------------------------------------
