------------------------------------------------------------------------------------------------------------------------------------------------------
------------------------------------------------------------------------------------------------------------------------------------------------------
------------------------------------------------------------------------------------------------------------------------------------------------------
------------------------------------------------------------------------------------------------------------------------------------------------------
------------------------------------------------------------------------------------------------------------------------------------------------------
-------------------------------------------------------------------------------------------------------------------k----------------------------------
-----------------------------------------------------------------------------------------------##-----------------S!S--S!S----------------------------
--------------------------------------------oooo----------oooo---------------------------------##-----------------------------------------------------
---------------------------------------------------------------------------------------------#-##------------------------------------------#----------
---------------------------------------------------------------------------------------------#-##------------------------------------k-----#----------
-----------!----------------!--------------------------TT--------------T-------------------#-#-##-----------------S!S--S@S--------SCSSS----#----------
------------------------------K-----------#------------TT--------------TT------------------#-#-##-----------------------------------K-----##---------#
------------------------------------------#------------TT--------------TT-----------TT---#-#-#-##--------F--------------------------------##--------##
------------------------------------------#---------y--TT---y------y---TT-----------TT---#-#-#-##--------#------k------ggg--------K---K---##-------###
XXXXXXXXXXXXXX--XX---XXXXXXXXXXXXXXXXXXXXXXXXXXXXXXXXXXXXXXXXXXXXXXXXXXXXXXXXXXXXXXXXXXX-X-X-X-XXXXXXXXXXXXXXXXXXXXXXXXXXXXXXXXXXXXXXXXXXXXX---XXXXXXX
XXXXXXXXXXXXXX--XX---XXXXXXXXXXXXXXXXXXXXXXXXXXXXXXXXXXXXXXXXXXXXXXXXXXXXXXXXXXXXXXXXXXX-X-X-X-XXXXXXXXXXXXXXXXXXXXXXXXXXXXXXXXXXXXXXXXXXXXX---XXXXXXX
