------------------------------------------------------------------------------------------------------------------------------------------------------
------------------------------------------------------------------------------------------------------------------------------------------------------
------------------------------------------------------------------------------------------------------------------------------------------------------
------------------------------------------------------------------------------------------------------------------------------------------------------
------------------------------------------------------------------------------------------------------------------------------------------------------
------------------------------------------------------------------------------------------------------------------------------------------------------
--------------------------------US------------------------------------------------------------------------------------------------------------USSS----
------------------------------------------------------------------------------------------------------------------------------------------------------
------------------------------------------------------------------------------------------------------------------------------------------------------
---------------------------------------------------------------oo-------------------------------------------------------------------------------------
------------!!-----------------####--SSC----------------------o--o---------------------------------------------------------------------------S-----TT-
--------------------------y-#####---------------------------------------------#-----------------------TT-----TT----K-------------------------------TT-
-----------------------y-######-------------------------------------------K---#-----------------------TT-----TT------------------------------------TT-
----------------------#######------------------y-y----------------------------#---------ggg---------kkTT-----TT-----------ggg-------ggg----k-ggg---TT-
XXXXXXXXXXXXXXXX--XXXXXXXXX------XX--XXXXXXXXXXXXXXXX--XXXXXXXXXXXXXXXXXXXXX--XXXXXXXXXXXXXXXXXXXXXXXXXXXXX--XXXXXXXXXXXXXXXXXXXXXXXXXXXXXXXXXXXXXXXXX
XXXXXXXXXXXXXXXX--XXXXXXXXX------XX--XXXXXXXXXXXXXXXX--XXXXXXXXXXXXXXXXXXXXX--XXXXXXXXXXXXXXXXXXXXXXXXXXXXX--XXXXXXXXXXXXXXXXXXXXXXXXXXXXXXXXXXXXXXXXX
