------------------------------------------------------------------------------------------------------------------------------------------------------
------------------------------------------------------------------------------------------------------------------------------------------------------
------------------------------------------------------------------------------------------------------------------------------------------------------
------------------------------------------------------------------------------------------------------------------------------------------------------
-----------------------------K------------------------------------------------------------------------------------------------------------------------
------------------------------------------------------------------------------------------------------------------------------------------------------
----------------------------###-----------------------------------------------------------------------------------------------------------------------
----------------------------###-----------------------------------------------------------------------------------------------------------------------
----------------------------###-------------------------------------------------#---------------------------------------------------------------------
----------------------------###--------------1---------------------------------##--oo------o----o-------------------oo---oo---------------------------
--------!!-----------------####-----------------------------------------------###---------------------------------------------------------------------
----------------------y-#######----------------------------------------------####---------------------------------------------------------------TT----
-------------------y-######-###--------F------------------------------------#####----------------------#---#------------------------------------TT----
------------------#######----##--------#--------------ggg-------ggg------gg######--k-------------------#-k-#-----------------------k------kkk---TT----
XXXXXXXXXXXX--XXXXXXXXX-----XXXXXXXXXXXXXXXXXXXXXXXXXXXXXXXXXXXXXXXXXXXXXXXXXXXXXXXXXXXXXX---XX---XXXXXXXXXXXXXXXX-----X----XXXXXXXXXXXXXXXXXXXXXXXXXX
XXXXXXXXXXXX--XXXXXXXXX-----XXXXXXXXXXXXXXXXXXXXXXXXXXXXXXXXXXXXXXXXXXXXXXXXXXXXXXXXXXXXXX---XX---XXXXXXXXXXXXXXXX-----X----XXXXXXXXXXXXXXXXXXXXXXXXXX
