-----------------------XXXXXXXXXXX---XXXXXXXXXX--XXXXXXXXXXXXXXXXXXXXXXXXXXXXXXXXXXXXXXXXXXXXXXXXXXXXXXXXXXXXXXXXXXXXX-XXXXXXXXXXXXXXXXXXXXXXXXXXXXXXX
------------------------------------------------------------------------------------------------------------------------------------------------------
------------------------------------------------------------------------------------------------------------------------------------------------------
------------------------------------------------------------------------------------------------------------------------------------------------------
----------------------------------------------------------------------------------------------------------------------U-------------------------------
--------------------------------------------------------------------------------------XX--------------------------------------------------------------
--------------------------------------------------------------------------------------XX------------------------------------------------k-------------
------------------------------------------------------------SSSSS---@-------------C---XX-------------SSSSS------------------------------##------------
--------------------------------------------------------------------------------------XX--------------------------------SS-------------###------------
--------------------------------------------------------------------------------------XX-------------------------------------#--------####------------
------------!!-------------#----------------------------------------------------------XX--------------K-------------SS------##-------#####------------
--------------------------##-----------------------------C--------!--------------SS---XX-------------SSSSS-----------------###------######------------
-----------------------yy###----------------------#---------------------TT------------XX----------------K---#----B--------####-----#######------------
----------------------#######-----------------K---#---------------------TT------------XX--------F-----------#----b-------#####----########--------F---
XXXXXXXXXXXXXXXX--XXXXXt####-----k----------------#-----gg-------K-K----TT--------k---XX--------X-----------#----B------######---#########--------#---
XXXXXXXXXXXXXXXX--XXXXXXXXXXXXXXXXX---XXXXXXXXXX--XXXXXXXXXXXXXXXXXXXXXXXXXXXXXXXXXXXXXXXXXXXXXXXXXXXXXXXXXXXXXXXXXXXXX-XXXXXXXXXXXXXXXXXXXXXXXXXXXXXX
