------------------------------------------------------------------------------------------------------------------------------------------------------
------------------------------------------------------------------------------------------------------------------------------------------------------
------------------------------------------------------------------------------------------------------------------------------------------------------
------------------------------------------------------------------------------------------------------------------------------------------------------
------------------------------------------------------------------------------------------------------------------------------------------------------
-------------------------------------------------------k---------------------------------------k------------------------------------------------------
-----------------------------------##-----------------S!S--S!S--------------------------------##----------------------------------##------------------
--------------------------------#--##--------------------------------------------------------###---------------------------------###------------------
---------------------g----------#--##------------------------------------------#-----------k####--------------------------------####------------------
-----------------######--#--#-#-#--##------------------------------------k-----#-----------#####-------------------------------#####------------------
----------------####--#--#--#-#-#--##-----------------S!S--S@S--------SCSSS----#----------######--------------SS!S------------######------------------
---------------##-----#--#--#-#-#--##-----------------------------------K-----##---------#######-----------------------------#######--------------K---
--------------##------#--#--#-#-#--##--------F--------------------------------##--------########--------F----------------tt-########--------F---------
-------------###------X--X--X-X-X--##--------#------k------ggg--------K---K---##-------#########--------#-----------gg---tt#########--------#---------
XXXXXXXXXXXXXXXX------X--X--X-X-X--XXXXXXXXXXXXXXXXXXXXXXXXXXXXXXXXXXXXXXXXXXXXX---XXXXXXXXXXXXXXXXXXXXXXXXXXXXXXXXXXXXXXXXXXXXXXXXXXXXXXXXXXXXXXXXXXX
XXXXXXXXXXXXXXXX-------------------XXXXXXXXXXXXXXXXXXXXXXXXXXXXXXXXXXXXXXXXXXXXX---XXXXXXXXXXXXXXXXXXXXXXXXXXXXXXXXXXXXXXXXXXXXXXXXXXXXXXXXXXXXXXXXXXX
