------------------------------------------------------------------------------------------------------------------------------------------------------
------------------------------------------------------------------------------------------------------------------------------------------------------
------------------------------------------------------------------------------------------------------------------------------------------------------
------------------------------------------------------------------------------------------------------------------------------------------------------
------------------------------------------------------------------------------------------------------------------------------------------------------
------------------------------------------------------------------------------------------------------------------------------------------------------
---------------------------------##-----------------------------------------------------------------------------##------------------------------------
---------------------------------##-----------------------------------------------------------------------------##------------------------------------
---------------------------------##--------------------------------------------TT-------------------------------##------------------------------------
--------------------------K---#--##--------------------------------------------TT------------------------K---#--##------------------------------------
----------!!-----------------##--##-----------------------------------#LSS-----##---------------------------##--##-------------------------------!----
----------------------------###--##--------------K--------------------#------------------------------------###--##------------------------------------
---------------------------####------------F--------------------------#-----------*---TT-----*------------####------------F---------------------------
--------------------K-----#####------------#----------ggg-----------kk#-----------*---TT-----*-----K-----#####------------#------k--------------------
XXXXXXXXXXXXXX--XXXXXXXXXXXXXXXXXXXXXXXXXXXXXXXXXXXXXXXXXXXXXXXXXXXXXXXXXXX---XXXXXXXXXXXXXXXXXXXXXXXXXXXXXXXXXXXXXXXXXXXXXXXXXXXXXXXXX---XXXXXXXXXXXX
XXXXXXXXXXXXXX--XXXXXXXXXXXXXXXXXXXXXXXXXXXXXXXXXXXXXXXXXXXXXXXXXXXXXXXXXXX---XXXXXXXXXXXXXXXXXXXXXXXXXXXXXXXXXXXXXXXXXXXXXXXXXXXXXXXXX---XXXXXXXXXXXX
