----------------------------------------------------------------------------------------------------------------------------------------------------------------------------------------------------------------------------------------------------------
----------------------------------------------------------------------------------------------------------------------------------------------------------------------------------------------------------------------------------------------------------
----------------------------------------------------------------------------------------------------------------------------------------------------------------------------------------------------------------------------------------------------------
S------SSSSSSSSSSSSSSSSSSSSSSSSSSSSSSSSSSSSSSSSSSSSSSSSSSS----------SSSSSSSSSSSSSSSSSSSSSSSSSSSSSSSSSSSSSSSSSSSSSSSSS-----SSSSSSSSSSSSSSSSSSSSSSSSSSS---------SSSSSSSSSSSSSSSSSSSSSSSSSSSSSSSSSSSSSSS-----SSSSSSSSSSSSSSSSSSSSSSSSSSS---------U-----------
S--------------------SSSSSSSSSSSSSSSSSSSSSSSSSSSS-------------------------------------------------------------------------SSSSSSSSSSSSSSSS----------------------------------------------------------------SSSSSSSSSSSSSSSS--------------------------------
S--------------------SSSSSSSSSSSSSSSSSSSSSSSCSSSS-------------------------------------------------------------------------SSSSSSSSSSSSSSSS----------------------------------------------------------------SSSSSSSSSSSSSSSS--------------------------------
S--------------------SSSSSSSSSSSSSSSSSSSSSSSSSSSS--!!------------CSS------------------------------------------------------SSSSSSSSSSSSSSSS-----------------CSS--------------------------------------------SSSSSSSSSSSSSSSS----------------------------##--
S------------------------------------------------------------------------------TT-----------------------------------------S-------------------TT-------------------------TT-------------------------------S-------------------TT----------------SS----##--
S-----------------------------------------------------------SSS--2-------------TT-----------------------------------------S-------------------TT------SSS--2-------------TT-------------------------------S-------------------TT-------SSS----------####--
S-------------------------------------------ggg-----------------2-2------------TT-------S-----------------------------------oooooooooo--------TT----------2-2------------TT-------S-------------------------oooooooooo--------TT-----------SSS------####--
S----------------------SSSSSS@-SSSSSSSSSSSSSSSSSS--!!--!!!---------2---------SCTTSU----------------------------------------USSSSSSSSSS----#---TT----F--------2---------SCTTSU------------------------------USSSSSSSSSS----#---TT----F--------------#####--
S----------------------SSSSS---SSSSSSSSSSSSSSSSSS------------------------TT----TT----TT---tt-------------#----------#--------------------##---TT---SS--------------TT----TT----TT---tt--------------#--------------------##---TT---SS-------------######--
S----------------------SSSSS---SSSSSSSSSSSSSSSSSS------------------------TT----TT----TT---tt------------##---------##-SSS---------------###---TT---SS--------------TT----TT----TT---tt-------------##-SSS---------------###---TT---SS------------#######--
S---------------------------oooSSSSSSSSSSSSSSSSSS------------------------TT---kTT---kTT--ktt---------kk-##--------###-------------kk---####--kTT---SS--------------TT---kTT---kTT--ktt------------###-------------kk---####--kTT---SS-----------########--
XXXXXXXXXXXX--XX--X---XXXXXXXXXXXXXXXXXXXXXXXXXXXXXXXXXXXX------XXXXXXXXXXXXXXXXXXXXXXXXXXXXXXXXXXXXXXXXXX--XXXXXXXXX-----XXXXXXXXXXXXXXXXXXXXXXX--XX-----XXXXXXXXXXXXXXXXXXXXXXXXXXXXXXXXXXXXXXXXXXX-----XXXXXXXXXXXXXXXXXXXXXXX--XX------XXXX-XXXXXXXXXX
XXXXXXXXXXXX--XX--X---XXXXXXXXXXXXXXXXXXXXXXXXXXXXXXXXXXXX------XXXXXXXXXXXXXXXXXXXXXXXXXXXXXXXXXXXXXXXXXX--XXXXXXXXX-----XXXXXXXXXXXXXXXXXXXXXXX--XX-----XXXXXXXXXXXXXXXXXXXXXXXXXXXXXXXXXXXXXXXXXXX-----XXXXXXXXXXXXXXXXXXXXXXX--XX------XXXX-XXXXXXXXXX
