------||||||--|--|||--|||||-----||-----------|||-----------|||----|------||||----------------||----||||||--%%%-||----||----XXXXXXXXXXXXXXXXXXXXXXXXXXXXXXXXXXXXXXXXXXXXXXXXXXXXXXXXXXXXXXXXXXXXXXXXXXXXXXXXXXXXXXXXXXXXXXXXXXXXXXXXXXXXXXXXX----XXXXXXXXXX
-----------------------------------------------------------|||----|--------------------------||----||||||---|--||----||----XXXXXXXXXXXXXXXXXXXXXXXXXXXXXXXXXXXXXXXXXXXXXXXXXXXXXXXXXXXXXXXXXXXXXXXXXXXXXXXXXXXXXXXXXXXXXXXXXXXXXXXXXXXXXXXXX----XXXXXXXXXX
----------------------------------------------------------------------------------------------------------------------------------------------------------------------------------------------------------------------------------------------------------
----------------------------------------------------------------------------------------------------------------------------------------------------------------------------------------------------------------------------------------------------------
-------------------oo----------------------------g-g------------------------------------------------------------------------------------------------------------------------------------------------------------------------------------------------------
--------------------------g-g-------------------%%%%------------------------------------------------------------------------------------------------------------------------------------------------------------------------------------------------------
---------ooor---------%%%%%%%---------------o-%%|||--------------------R----------oo----------------------------------------------------------------------------------------------------------------------------------------------------------------------
--------%%%%%----------|||||-----------------%|||||---oo--oo-----------------g----------oo--oo------------------------------------------------------------------------------------------------------------------------------------------------------------
---------|||-----------|||||----oo---SSSS-----|||||----------------------%%%%%%------------------------------R-----oo--------------------##----------------------------------LSSS---------------------!!!!!-----------USSS--------SSCSS------SSSS---------
---------|||-----------|||||------------------|||||-----------------------||||-----------------------r-----------------------------------##---------------------------------------------------------------------------------------------------------------
---------|||-----%%%%%-|||||------------------|||||-----------------------||||---------------------%%%%%%%%-------------------SSS------####------------------------------g--------------------------------------------------------------------------------
------%%%%%%%%----|||--|||||------------------|||||-----------------------||||-----SS---------------||||||-----------------------------####------------------------------#------------------------------k-----------------------------------------------g-
-------||||||-----|||--|||||------------------|||||----SS---------%%%-----||||-----------SS---------||||||-----%%%%--%%%%------------######--------------SS!S-----------##---2-----#-----------TT-----@!!!!----------S-----TT---!!!!--!!!---------------TT
%%%%---||||||--o--|||--|||||------------------|||||----------------|------||||----------------------||||||------||----||-------------######-----------------------------##---------#-----------TT--------------------------TT---------------------------TT
-||----||||||-%%%-|||--|||||------------------|||||--------%-------|------||||---------------%%%%---||||||------||----||-------------######--------F----------------tt-###---------##----------TT--------------------------TT---------------------------TT
-||----||||||--|--|||--|||||----%%%%----------|||||---------%%%%---|------||||----------------||----||||||--ooo-||----||---------r---######--------#-----------gg---tt####----kk---##---gg-----TT------------gg----k-ggg---TT------------ggg------------TT
