---------------------------------------------------------------------------------------------------------------------------------------------------------------------------------------------|----------------------------------------------------------------------------------------------SSSS------------
---------------------------------------------------------------------------------------------------------------------------------------------------------------------------------------------|-------------------------------SSS------------------------------------------------------------------------oo--
---------------------------------------------------------------------------------------------------------------------------------------------------------------------------------------------|----------------------------------------------------------------------------------------SSS---------------SS--
------------------------------------------------------------------------------------------------------------------------------------------------oo-------------------------------------------|---%%%%------oooo------------------------oo-oo@o--------------------------------------------------SSSS--------
-----------------------------------------------------------------------------------------------------------------------------------------@-----%%%%---------------------------------o--------|----||--------------%%%%%%--------------o-------------oo-------%------%%%%-------r-r--------------------------
--------------------------------------------------------------------------------------------------------------------SSS-------------------------||--------------------R------------------SS-%%%%%%||---------------||||-------------------------------------%-%--%---||----%%%%%%%%%%%%--------------------S
----------------------------------------SUS-----------------------------------------------------------------------------------------------------||--------------------------g------o---------||||-||---------------||||----------------SSSSSSSS--------C---%|--%%-%%-||-----||||||||||----------------------
------------------------------------------------------------------------------------------------------------------g----------o----ooo------r----||--SSS---o---o---------%%%%%%-----S---------||||-||---------------||||-----------------------------------%||--|--|--||-----||||||||||----------------------
--------------------------------------------------------------------------------------------------------------%%%%%%-------------------%%%%%%---||-------%%%-%%----------||||--------SS------||||-||%%%%%%%%%-%%%%-||||-%%%%%%----%%%%-------------------%|||--------||-%%%-||||||||||----------------------
---------------------------------------------------------------------------------------------------------------||||----SSS--------------||||----||--------|---|----------||||----------------||||-||-|||||||---||--||||--||||------||----------------SSS-||||------------|--||||||||||--------------%%%%----
---------------------------------------#####-------------------------------------------------------------------||||----------------%%%%-||||ooo-||--------|---|---%%%----||||---------------------------------------------------------------------------%||||----------------------------------------||-----
-------K-------------------------------#--------------------------#---------------------------------------%%%%%||||-----------------||--||||--r-||--------|---|----|-----||||---------------------------------------------------------------------------||||------------------------------------------------
--------------------------------------K#---------------------*----#----------------------------------*-----|||-||||-----------------||%%%%%%%%%%||--------|---|----|-----||||---------------------------------------------------------------------------|||-------------------------------------------------
--M-----------ggg-------ggg------------#--------------ggg----*----#----ggg--k----ggg----------ggg----*-----|||-||||----oo---%%%%%%%-||-||||||||-||--------|---|r---|-----||||----------------ooo--------------------------------------------------------||--------------------------------------------------
XXXXXXXXXXXXXXXXXXXXXXXXXXXXXXXXXXXXXXXXXX----XXXXXXXXXXXXXXXXXX--XXXXXXXXXXXXXXXXXXXXXXXXXXXXXXXXXXXXXX---|||-||||---%%%----|||||--||-||||||||-||-------%%%%%%%%%-|-----||||----------------%%%------------------------------------------------------------------------------------------------------------
XXXXXXXXXXXXXXXXXXXXXXXXXXXXXXXXXXXXXXXXXX----XXXXXXXXXXXXXXXXXX--XXXXXXXXXXXXXXXXXXXXXXXXXXXXXXXXXXXXXX---|||-||||----|-----|||||--||-||||||||-||--------|||||||--|-----||||-----------------|-------------------------------------------------------------------------------------------------------------
