----------------------------------------------------------------------------------------------------------------------------------------------------------------------------------------------------------------------------------------------------------
----------------------------------------------------------------------------------------------------------------------------------------------------------------------------------------------------------------------------------------------------------
----------------------------------------------------------------------------------------------------------------------------------------------------------------------------------------------------------------------------------------------------------
----------------------------------------------------------------------------------------------------------------------------------------------------------------------------------------------------------------------------------------------------------
----------------------------------------------------------------------------------------------------------------------------------------------------------------------------------------------------------------------------------------------------------
-------------------------------------------------------------------------------------------------------------------------------------------------------------------------------------------------------------------k--------------------------------------
-----------------------------------------------------------------------------------------------------------------------------------------------------------------------------------------------##-----------------S!S--S!S-----------------------------SS!
-----------------------------------------------------------------------------------------------------------------------------------------------------------------------------------------------##---------------------------------------------------------
------------------------------------------------------------------------------------#-------------------------------------------------------------------------TT-------------------------------##------------------------------------------#--------------
---------------------------oo---------------------tt-------------------------------##--oo------o----o----o----------------------------------------------------TT------------------------K---#--##------------------------------------k-----#-------------K
----------------------------------------------TT--tt------------------------------###----------------------------------------------------------------#LSS-----##---------------------------##--##-----------------S!S--S@S--------SCSSS----#-----------SSS
-------K----------------------------------TT--TT--tt-----------------------------####---------------------------------#------------------------------#------------------------------------###--##-----------------------------------K-----##--------------
---------------#--------------------------TT--TT--tt----------------------------#####---------------------------#-----#------------------------------#-----------*---TT-----*------------####------------F--------------------------------##--------------
--M----------kk#---------------------ggg--TT--TT--tt-----k--ggg-----ggg------gg######--k------------------------#-----#----ggg--k----ggg-----------kk#-----------*---TT-----*-----K-----#####------------#------k------ggg--------K---K---##-------y------
XXXXXXXXXXXXXXXXXXXXXXXXX------XXXXXXXXXX-XX--XX--XXXXXXXXXXXXXXXXXXXXXXXXXXXXXXXXXXXXXXXXXXXX---XX---XX---XXXXXXXXX--XXXXXXXXXXXXXXXXXXXXXXXXXXXXXXXXXXXX---XXXXXXXXXXXXXXXXXXXXXXXXXXXXXXXXXXXXXXXXXXXXXXXXXXXXXXXXXXXXXXXXXXXXXXXXXXXXXXX---XXXXXXXXXXX
XXXXXXXXXXXXXXXXXXXXXXXXX------XXXXXXXXXX-XX--XX--XXXXXXXXXXXXXXXXXXXXXXXXXXXXXXXXXXXXXXXXXXXX---XX---XX---XXXXXXXXX--XXXXXXXXXXXXXXXXXXXXXXXXXXXXXXXXXXXX---XXXXXXXXXXXXXXXXXXXXXXXXXXXXXXXXXXXXXXXXXXXXXXXXXXXXXXXXXXXXXXXXXXXXXXXXXXXXXXX---XXXXXXXXXXX
