----------------------------------------------------------------------------------------------------------------------------------------------------------------------------------------------------------------------------------------------------------
----------------------------------------------------------------------------------------------------------------------------------------------------------------------------------------------------------------------------------------------------------
----------------------------------------------------------------------------------------------------------------------------------------------------------------------------------------------------------------------------------------------------------
----------------------------------------------------------------------------------------------------------------------------------------------------------------------------------------------------------------------------------------------------------
----------------------------------------------------------------------------------------------------------------------------------------------------------------------------------------------------------------------------------------------------------
----------------------------------------------------------------------------------------------------------------------------------------------------------------------------------------------------------------------------------------------------------
-----------------------------------------------------------------------------------------------------------------------------------------##---------------------------------------------------------------------------------------------------------------
-----------------------------------------------------------------------------------------------------------------------------------------##---------------------------------------------------------------------------------------------------------------
------------------------------------------------------------------------------------#--------------------------------------------------#-##---------------------------------------------------------------------------------------------------------------
---------------------------oo---------------------tt-------------------------------##--oo------o---------------------------------------#-##---------------------------------------------------------------------------------------------------------------
----------------------------------------------TT--tt------------------------------###------------------------------------------------#-#-##---------------------------------------------------------------------------------------------------------------
-------K----------------------------------TT--TT--tt-----------------------------####------------------------------TT----------------#-#-##---------------------------------------------------------------------------------------------------------------
---------------#--------------------------TT--TT--tt----------------------------#####------------------------------TT---------TT---#-#-#-##--------F------------------------------------------------------------------------------------------------------
--M----------kk#---------------------ggg--TT--TT--tt-----k--ggg-----ggg------gg######--k--------------k------kkk---TT---------TT---#-#-#-##--------#------------------------------------------------------------------------------------------------------
XXXXXXXXXXXXXXXXXXXXXXXXX------XXXXXXXXXX-XX--XX--XXXXXXXXXXXXXXXXXXXXXXXXXXXXXXXXXXXXXXXXXXXX---XXXXXXXXXXXXXXXXXXXXXXXXXXXXXXXXX-X-X-X-XXXXXXXXXXX------------------------------------------------------------------------------------------------------
XXXXXXXXXXXXXXXXXXXXXXXXX------XXXXXXXXXX-XX--XX--XXXXXXXXXXXXXXXXXXXXXXXXXXXXXXXXXXXXXXXXXXXX---XXXXXXXXXXXXXXXXXXXXXXXXXXXXXXXXX-X-X-X-XXXXXXXXXXX------------------------------------------------------------------------------------------------------
