----------------------------------------------------------------------------------------------------------------------------------------------------------------------------------------------------------------------------------------------------------
----------------------------------------------------------------------------------------------------------------------------------------------------------------------------------------------------------------------------------------------------------
----------------------------------------------------------------------------------------------------------------------------------------------------------------------------------------------------------------------------------------------------------
----------------------------------------------------------------------------------------------------------------------------------------------------------------------------------------------------------------------------------------------------------
----------------------------------------------------------------------------------------------------------------------------------------------------------------------------------------------------------------------------------------------------------
----------------------------------------------------------------------------------------------------------------------------------------------------------------------------------------------------------------------------------------------------------
----------------------------------------------------------------------------------------------------------------------------------##----------------------------------------------------------------------------------------------------------------------
----------------------------------------------------------------------------------------------------------------------------------##----------------------------------------------------------------------------------------------------------------------
----------------------------------------------------------------------------------------------------------y-----------------------##----------------------------------------------------------------------------------------------------------------------
---------------------------------------------------------o---------------1--------o--------o--------------XSS-@!---------------#--##----------------------------------------------------------------------------------------------------------------------
----------------------------TT---------------------------------------TT----------------TT--------TT------XX-------------------##--##----------------------------------------------------------------------------------------------------------------------
-------K--------------------TT---------------------------------------TT----TT----------TT--------TT-----XXX------------------###--##----------------------------------------------------------------------------------------------------------------------
----------------------------TT---------------------------------------TT----TT----------TT--------TT----XXXX-------y---------####------------F-------------------------------------------------------------------------------------------------------------
--M-----------ggg-------ggg-TT----k-k---------------k---------ggg----TT---kTT----------TT--------TT---XXXXX---SSSSS-----y--#####------------#-------------------------------------------------------------------------------------------------------------
XXXXXXXXXXXXXXXXXXXXXXXXXXXXXXXXXXXXXXX-X-XX-XX-XX-XXXXXXXXXXXXXXXXXXXXXXXXXXXXXXXXXXXXXXXXXXXXXXXXXXXXXXXX-------XX-XXXXXXXXXXXXXXXXXXXXXXXX-------------------------------------------------------------------------------------------------------------
XXXXXXXXXXXXXXXXXXXXXXXXXXXXXXXXXXXXXXX-X-XX-XX-XX-XXXXXXXXXXXXXXXXXXXXXXXXXXXXXXXXXXXXXXXXXXXXXXXXXXXXXXXX-------XX-XXXXXXXXXXXXXXXXXXXXXXXX-------------------------------------------------------------------------------------------------------------
