--------------------------------------------------------------------------
--------------------------------------------------------------------------
--------------------------------------------------------------------------
--------------------------------------------------------------------------
--------------------------------------------------------------------------
--------------------------------------------------------------------------
----------------------------------------------------------------##--------
----------------------------------------------------------------##--------
----------------------------------------------------------------##--------
-------------------------------------------------------------#--##--------
-------------------------------------oo---------------------##--##--------
-------K---------------------------------------------------###--##--------
----------------------------------------------------------####------------
--M-----------ggg---------y-y-------------------y--------#####------------
XXXXXXXXXXXXXXXXXXXXXXXXXXXXXXXX--XXXXXXXXXXXXXXXXXXXXXXXXXXXXXXXXXXXXXXXX
XXXXXXXXXXXXXXXXXXXXXXXXXXXXXXXX--XXXXXXXXXXXXXXXXXXXXXXXXXXXXXXXXXXXXXXXX
