----------------------------------------------------------------------------------------------------------------------------------------------------------------------------------------------------------------
----------------------------------------------------------------------------------------------------------------------------------------------------------------------------------------------------------------
----------------------------------------------------------------------------------------------------------------------------------------------------------------------------------------------------------------
----------------------------------------------------------------------------------------------------------------------------------------------------------------------------------------------------------------
-----------------------------------------------------------------------------------------------------------------------------------------------------------------------------------------------------K----------
-------------------------------------------K-------------------------------------------------------------------k------------------------------------------------------------------------------------------------
---------------------------------------SSSSSS----1--------------------------------------------------------S---SSSSSSSSS------------US---SS-------------SSS-------------------------------------------##---------
------------------------------------------------------------------------------------------------------TT------------------------------------------------------TT------------------------------------###---------
------------------------------------------------------------------------------------------------------TT------------------------------------------------------TT-----------------------------------####---------
----------------------------------------K-------------------------------------------------------------TT-------------------------SS---------------------------TT----------------------------------#####---------
--------------------------------------SSSSSSS------------------------------------##--#-------tt------SXXS------------------------------SSS---------#---SSS----XX-----TT-------TT----------------TT#####---------
-------K--------------------T--------------------TT--------------TT-------------###--##------tt-----------------------------------------------#-TT-#-----------------TT-----TTTT----TT---------#TT#####---------
---------------#------------T--------------------TT---------B----TT----TT------####--###-----tt-TT--------TT--------------TT--TT-------------##-TT-##----------------TT---TTTTTT----TT--------##TT#####--------F
--M----------kk#------------T-----k--------------TT---------b----TT-k--TT-----#####--####----tt-TT--------TT--------------TT--TT------------###-TT-##---------k------TT---TTTTTT----TT-------###TT#####--------#
XXXXXXXXXXXXXXXXXXXXXXXXX---XXXXXXXXXXXXXXXXXXXXXXXXXXXXXXXXXXXXXXXXXXXXXXXXXXXXXXX--XXXXXXXXXXXXXXXXXXXXXXXXXXXXX------XXXXXXXXXXXX-X-XXXXXXXX-XXXXXXXXXXXXXXXXXXXXXXXXXXXXXXXXXXXXXXXXXXXXXXXXXXXXXXXXXXXXXXXX
XXXXXXXXXXXXXXXXXXXXXXXXX---XXXXXXXXXXXXXXXXXXXXXXXXXXXXXXXXXXXXXXXXXXXXXXXXXXXXXXX--XXXXXXXXXXXXXXXXXXXXXXXXXXXXX------XXXXXXXXXXXX-X-XXXXXXXX-XXXXXXXXXXXXXXXXXXXXXXXXXXXXXXXXXXXXXXXXXXXXXXXXXXXXXXXXXXXXXXXX
