--------------------------------------------------------------------------
--------------------------------------------------------------------------
--------------------------------------------------------------------------
--------------------------------------------------------------------------
--------------------------------------------------------------------------
---------------------------------------------------------------y----------
--------------------------------------------1------------------##---------
-------------------------------------------------------------y###---------
-------------------------------------------------------------####---------
------------------------------------------------------------#####---------
-------------------------------------------!!!-------------######---C-----
-------K--------------------------------------------------#######---------
---------------#-----------------------------------------########--------F
--M----------kk#--------------y--y----------y-----------#########--------#
XXXXXXXXXXXXXXXXXXXXXXXXX---XXXXXXXXXXXXXXXXXXXXXXXXXXXXXXXXXXXXXXXXXXXXXX
XXXXXXXXXXXXXXXXXXXXXXXXX---XXXXXXXXXXXXXXXXXXXXXXXXXXXXXXXXXXXXXXXXXXXXXX
