----------------------------------------------------------------------------------------------------------------------------XXXX|-------------------------------------------------------------------------------------------------------------------------------------||||||--%%%-||----||----XXXXXXXXXXXXXXXXXXXXXXXX-
-----------------------------------------------------------------------------------------------------------------------------------------------------o----------------------------------------------------------------------------------------------------------------||||||---|--||----||----XXXXXXXXXXXXXXXXXXXXXXXX-
-----------------------------------------------------------------------------------------------------------------------------------------------------%o-----------R----------------------------------------------------------------------------------------------------------------------------------------------------
-----------------------------------------------------------------------------------------------------------------------------------------------------|%%----------------g-------------------------------------------------ooo------------------------------------------------------------------------------------------
-----------------------------------------------------------------------------------------------------------------------------------------------SSS---||--o----------%%%%%%------------------@-----------------------------%%%------------------------------------------------------------------------------------------
------------------------------------------------------------------------------------------------------------------------------------------%----------||-%%%----------||||-------ooooooo------------------------------------|-------------------oo--oo------------------------------------------------------------------
--------------------------------------------------------------------------SUS-----------------------------------SS--------------X----------%%%-------||--|-----------||||-----SSS---------------------------SSoo----SS-----|-----------oo---------------------------RR-------------------------------------------------
--------------------------------------------------------------------------------------------------------------------------------X--------%-||-------%||%-|-----%%----||||-----------------SSSS-----------------------------|-----r------------------------------r------------------------------------------------------
--------------------------------------------------------------------------------------------------------------------------------X---o---%|-||--------||--|----%|-----||||----------SSSS------------------------------------|----%%%-----------------------%%%%%%%%--------------R-----oo--------------------##---------
-----------------------------------------------------------------------------------------------------------------K--------------X--------|%||--------||-%%%%---|-----||||--------------------------------------------------|---%|||%%---SSS----------------||||||-----------r-------------------------------##---------
-------------------------------------------------------------------------#####----------------------------------SSSSS-----------X--------|-||--------||-|||----|-----||||-----------------------------%%%%%%----SS-----SS--|----||||------------SSS--------||||||-----%%%%%%%%----------------------------####---------
-------K--------------------TT-----TT----K-------------------------------#--------------------------#--------------K-------g---XX--------|-||--------|%%|||----|-----||||------------------------SSS---||||---------------%%%%%%||||-----------------------||||||------||||||---------------------SSS-----####---------
----------------------------TT-----TT-----------------------------------K#---------------------*----#----------------------TT-XXX----%%%-|----------%%|-|||----|-----||||-------------%%%%%------------||||----------------||||-||||----------------%%%%---||||||------||||||-----%%%%--%%%%------------######---------
--M-----------ggg---------kkTT-----TT-----------ggg-------ggg------------#--------------ggg----*----#----ggg--k------------TTXXXX-%%%||--|-----------|---------------------------------|||-------------||||----------------||||-||||-----------------||----||||||--ooo-||||||------||----||-------------######---------
XXXXXXXXXXXXXXXXXXXXXXXXXXXXXXXXX--XXXXXXXXXXXXXXXXXXXXXXXXXXXXXXXXXXXXXXXXX----XXXXXXXXXXXXXXXXXX--XXXXXXXXXXXXXXXXXXXXXXXXXXXXX%|---------------------------------------------%%%%---|||-------------||||----------------||||-||||-----------------||----||||||--%%%-||||||------||----||-------------######--------F
XXXXXXXXXXXXXXXXXXXXXXXXXXXXXXXXX--XXXXXXXXXXXXXXXXXXXXXXXXXXXXXXXXXXXXXXXXX----XXXXXXXXXXXXXXXXXX--XXXXXXXXXXXXXXXXXXXXXXXXXXXXX|-----------------------------------------------||----|||-------------||||----------------||||-||||-----------------||----||||||---|--||||||--ooo-||----||---------r---######--------#
