----------------------------------------------------------------------------------------------------------------------------------------------------------------------------------------------------------------------------------------------------------------------------------------------------------------------------------------------------------------------
----------------------------------------------------------------------------------------------------------------------------------------------------------------------------------------------------------------------------------------------------------------------------------------------------------------------------------------------------------------------
----------------------------------------------------------------------------------------------------------------------------------------------------------------------------------------------------------------------------------------------------------------------------------------------------------------------------------------------------------------------
----------------------------------------------------------------------------------------------------------------------------------------------------------------------------------------------------------------------------------------------------------------------------------------------------------------------------------------------------------------------
----------------------------------------------------------------------------------------------------------------------------------------------------------------------------------------------------------------------------------------------------------------------------------------------------------------------------------------------------------------------
-----------------------------------------------------------------------------------------------------------------------------------------------------------------------------------------------k----------------------------------------------------------------------------------------------------------------------------------------------------------------------
--------------------LSSS---------------------!!!!!------------------------------------------------------------------------1-------USS------------------SS!SSS@SSS--------SSC------------------S!S--S!S----------------------SUS--------------------------------------------------------------------------------------------!---------------------------SSS------------
--------------------------------------------------------------------------------------------------------------------------------------------------------------------------------------------------------------------------------------------------------------------------------------------------------------------------------------------------------------TT------
----------------g--------------------------------------------------------------------T----------------------------------------------------------------------------------------------g#--------------------------------------------------------------------------------------------------------TT--------------------------------------------------------------TT------
----------------#------------------------------k-------------------------------------T------------------------------------ggg----------------------------K---------------SSS-------g##--------------------------------------------------------------------------------------------------------TT--------------------------------------------------------------TT------
-------SUS-----##---2-----#-----------TT-----@!!!!----------S----------------------------------------S--------------##########---#-------------TT------SSSSSSSSSSS-----------------###--------S!S--S@S--------SCSS---------#####-----------------------------------------------------#LSS-----##---------------------!---S@S!S@S-----!-----------------SSS----XX------
--------------###---------#-----------TT---------------------------TT---------tt-----------------TT----------------##--------#---#-------------TT---------------------------------####--------------------------K----------#--------------------------#------------------------------#-----------------------------------------------------------TT-------------------
-------------####---------##----------TT---------------------------TT---------tt-----------------TT--------TT-----###--------#---##------------TT--------------------------------#####------------------------------------K#---------------------*----#------------------------------#-----------*---TT-----*-------------------------------B----TT------------------F
--M---------#####----kk---##---gg-----TT------------gg----k-gg-----TT---------tt-g------------gggTT------k-TT----####--------#---##--gg----k---TT--------------K----------------######------k------ggg--------K------------#--------------ggg----*----#----ggg--k----ggg-----------kk#-----------*---TT-----*-------------g----------k------b----TT-----------k------#
XXXXXXXXXXXXXXXXXXXXXXXXXXXXXXXXXXXXXXXXXXXXXXXXXXXXXXXXXXXXXXXXXXXXXXXXXXXXXXXXXXXXXX--XXXXXXXXXXXXXXXXXXXXXXXXXXXXX--------X---XXXXXXXXXXXXXXXXXXXXXXXXXXXXXXXXXXXXXXX----XXXXXXXXXX--XXXXXXXXXXXXXXXXXXXXXXXXXXXXXXXXXXXXXX----XXXXXXXXXXXXXXXXXX--XXXXXXXXXXXXXXXXXXXXXXXXXXXXXXXXXXXX---XXXXXXXXXXXXXXXXXXXXXXXXXXXXXXXXXXXXXXXXXXXXXXXXXXXXXXXXXXXXXXXXXXXXXXXXX
XXXXXXXXXXXXXXXXXXXXXXXXXXXXXXXXXXXXXXXXXXXXXXXXXXXXXXXXXXXXXXXXXXXXXXXXXXXXXXXXXXXXXX--XXXXXXXXXXXXXXXXXXXXXXXXXXXXX--------X---XXXXXXXXXXXXXXXXXXXXXXXXXXXXXXXXXXXXXXX----XXXXXXXXXX--XXXXXXXXXXXXXXXXXXXXXXXXXXXXXXXXXXXXXX----XXXXXXXXXXXXXXXXXX--XXXXXXXXXXXXXXXXXXXXXXXXXXXXXXXXXXXX---XXXXXXXXXXXXXXXXXXXXXXXXXXXXXXXXXXXXXXXXXXXXXXXXXXXXXXXXXXXXXXXXXXXXXXXXX
