----------------------------------------------------------------------------------------------------------------------------------------------------------------------------------------------
----------------------------------------------------------------------------------------------------------------------------------------------------------------------------------------------
----------------------------------------------------------------------------------------------------------------------------------------------------------------------------------------------
----------------------------------------------------------------------------------------------------------------------------------------------------------------------------------------------
----------------------------------------------------------------------------------------------------------------------------------------------------------------------------------------------
-----------------------------------------------------------------------------------------------------------------k----------------------------------------------------------------------------
-------------------------------------------------------------------------SS!SSS@SSS--------SSC------------------S!S--S!S----------------------------------------------------------###---------
--------------------------------------------------------------------------------------------------------------------------------------------------------y-------------------------###---------
------------------------------------------------------------------------------------------------------g#---------------------------------#-----------k#SS--o-------------------y--###---------
---------------------------------------------------------------------------K---------------SSS-------g##---------------------------k-----#-----------##------------------------#--###---------
-----------------------------------------------------------------TT------SSSSSSSSSSS-----------------###--------S!S--S@S--------SCSSS----#----------###--SC-------------------##--###---------
-------K--------------------TT-----TT----K-----------------------TT---------------------------------####--------------------------K-----##---------####---------------------y###--###---------
----------------------------TT-----TT----------------------------TT--------------------------------#####--------------------------------##--------#####---SSS---------------####--###--------F
--M-----------ggg---------kkTT-----TT-----------ggg-------ggg----TT--------------K----------------######------k------ggg--------K---K---##-------######--------------------#####--###--------#
XXXXXXXXXXXXXXXXXXXXXXXXXXXXXXXXX--XXXXXXXXXXXXXXXXXXXXXXXXXXXXXXXXXXXXXXXXXXXXXXXXXXXXXXX----XXXXXXXXXX--XXXXXXXXXXXXXXXXXXXXXXXXXXXXXXXX---XXXXXXXXXX------XXXXXXXXX---XXXXXXX--XXXXXXXXXXXX
XXXXXXXXXXXXXXXXXXXXXXXXXXXXXXXXX--XXXXXXXXXXXXXXXXXXXXXXXXXXXXXXXXXXXXXXXXXXXXXXXXXXXXXXX----XXXXXXXXXX--XXXXXXXXXXXXXXXXXXXXXXXXXXXXXXXX---XXXXXXXXXX------XXXXXXXXX---XXXXXXX--XXXXXXXXXXXX
