----||||||------------------------------------------------%%-----------------------------------------%-------------------o-------------g--------------
----||||||----------------------------------------------------------o-%-------R---%-----S-------o-----%--------------------------------T-o------------
----|||||------------------------%%---------------------------------------%--------------S-----o---------------------------------------TT--%----------
----||||-------------------------|--------------------------------------%%---------------------S---------------------F--------------#--TT-------------
------------------------o---------------------------%------------------%||%%%%-----%o-----------SU--%-o--------------#---g---------###-TT-------------
-----------------------S-------------------%------%%%%g----------------|||-||-------------------------%-------XXXXXXXXXXXXX------k####gTT---##-####g-#
----------------------S---------------------%%%%%--|||%----------------|||-||-----%-------%----------%%%%-----XXXXXXXXXXXXX--XXXXXXXXXXXXX--########-#
---------o-----------S--S-------------------|--|---------%%-%%%%%%%%---|||-||-----|--------%-----%---|||---------------------XXXXXXXXXXXXX--####--#--#
--------------------------------------------|-------------|%|||||||----|||-||---%%%%-------|%%----%%%|||-------------------------------------|-------#
----%-oor--------------------------------------------------||-----|----||--------|||%%-----|||%%--||-||----------------------------------------------X
------%%%-----------------------SS----o--------------------------------------------||------||||---||-------------------------------------------------X
------||-------------------------------S---------------------------------------------------||||---||--------------------------------------------------
-----%||--%%------%%%%----------------S-S-----------o-R------------------------------------||T|-------------------------------------------------------
%%%%-|||-%|--%%%---||--------------------S-S-----------------------------------------------|||----------------S---------------------------------------
-||--|%%%||--||----||---------------------S-----------------------------------------------------------------------------------------------------------
-||--||||||--------||-----------------------------------S---o-----------------------------------------------------------------------------------------
