--------------------------------------------------------------------------------------------------S---SS------|---|||---||%|%-------%---------TT------
--------------------------------------------------------------------------------------------------S---SS------|---|||---|||||--------XXXXXXXXXXXXXXXXX
----------------------------------------------------------------------------------------------#-----T-SSoSSSSSS--%||%---|-|||--------XXXXXXXXXXXXXXXXX
----------------------------------------------------------------------------------------------S----TTT---SSSSS--r|S|-o-----||%-g----------------------
---------------------------------------------------------------------------------------------------TTT--SSSSSS--%|-|-%%%---|||-%%---------------------
---------------------------------------------------------------------------------------------------TTT--SSSSSSS-||g|-|-----|||r||---------------------
---------------------------------------------------------------------------2-----------------------TTTS-S---SSS-||-|-|%-g---||%||---------------------
------------%----------------------------------------------------------------------------------B---TXT------SSSr||%S-|--r---|||||%--------------------
-----------------------------------------------------------------------------------------------B---TXT-t-F--gSS%|||-%|--%----||%||-S------------------
---------------------------------------------------------------------------------------------SSX---TST-tk*SSSSS||||g-|--|----|||||--------------------
----------T--T---------------------------------####--#g----------------------------------------XXXXX-XXXXXSSSSS||||%-|%-|--%--||||--------------------
----------T--T-------------T-g----T----------B-#######T--------------T------------##-----------XXXXX-XXXXX-SSSS||||%-|--|%%---||||--------------------
----------TTtTt--K---------TTB---TT--g-------b-#######T-------y------TT----------###----------------S------SSyS||S%|%|--|||-%-||-|--------------------
------k-g-TTtTt---y-------yTT|---TT-#B------gS-#######T------#X-g----TT-g------###X#-g-----y--------S-----XXXXX||--|||---||-%-||-|%------------TT-----
XXXXXXXXXXXXXXXXXXXXXXXXXXXXXXXXXXXXXXXXXXXXXXXXXXXXXXXXXXXXXXXXXXXXXXXXXXXXXXXXXXXXXXXXXXXXXXX-----S-----XXXXX|%--|||---||-|--|-||------------TT-----
XXXXXXXXXXXXXXXXXXXXXXXXXXXXXXXXXXXXXXXXXXXXXXXXXXXXXXXXXXXXXXXXXXXXXXXXXXXXXXXXXXXXXXXXXXXXXXX-SSSSS-SSSSS----|---|||---||-|--|---------------TT-----
