---------------T--S-----------------------##---------------XXXXXXXXXXXXXXX--T###XXXXXX------------T----#--T-----------#----XXXXXXX--##---------#------
------------o-----------------------g-----##--------------------------------T###------------------T---F#--T---------------o---------##---------#------
------------%-%-----------------#---#--#--##----S---------------------------T###------------------T#--##--T-g-kg--------------------##---------#------
------------|g|-----------------#---#--#--##----------#-------------------XXXXXX------------------XXXXXXXXXXXXXXXXXX---------------###--!-!#---#-#--#S
---------%%-|%||-t------------#-#---#--#--##--#-------#-------------------XXXXXX------------------XXXXXXXXXXXXXXXXXX---------------####----#---#-##-#-
---------||-||||-tk-k---------#-#-#-#--#-k##-##---K--o#---#---------------------------#----------T---------------------S------------###F-F##---#-####-
---------||-||-XXXXXXXXXXXXXXXXXX-#-#XXXXXXXXXXXXXXXXXXXXXXX--------------------------#--T---k---T----------------------------------####-###---#-####-
----------|-|--XXXXXXXXXXXXXXXXXX-#-#XXXXXXXXXXXXXXXXXXXXXXX-----#--S-----------------#--T---X---#--------------------------##------XXXXXXXXXXXXXXXXXX
----------|%%---------------------#-#------------------------o--##-------o-S----------#--T---X------------------------------##------XXXXXXXXXXXXXXXXXX
----------|||---------------------#-#-----------------------T---##--------------------#--T---X-------------------------o----##------------------------
----T-------|--------S------------XXX-----------------------T---#---------------------#--T---Xg--K--------------------------##------------------------
----T-------|---------------------XXX-----------------------T---##------------#---T---#XXXXXXXXXXX-#----------S-------------##------------------------
----T-------|-----------------------------------------------t---##------------#---T---#XXXXXXXXXXX---------g----------------##------------------------
----T--k----|------------------------o----------------------t---##--------X--T#---T---#------------------o-T----------------##------------------------
XXXXXXXX--------T-------U--------o---------#k---------------t--g##K-g-----X--T#---T--y#--------------------T-----------g----##k-----------------------
XXXXXXXX--------T--------------------------##---------------XXXXXXXXXXXXXXX--T#--XXXXXX------------T----#--T---------o-#----XXXXXXX--##---------g-----
