--------------------------------|||||---------%%%%-----||||||--------SS------------||||||------------------------|------------------------------------
--------------------------------|||||----------||------||||||----------------------||||||-------%%%%--------------------------------------------------
--------------------------------|||||----------||------||||||--SSS------o------------------------||---------------------------------------------------
--------------------------------|||||----------||------||||||------------------------------------||---------------------------------------------------
--------------------------------|||||----------||------||||||------------o-----------------------||---------------------------------------------------
--------------------------------|||||----%%%%--||------||||||------------%%---------------------------------------------------------------------oo-o--
--------------------------------|||||-----||-----------------------------|----------------------------------------------------------------------------
-----------------------------r-------------------------------------------|--%%%%------------------------o----o----------------------------------------
--------------------%%%%%%%%%%%------------------------------------------|---||---------------------------------------------%%%%----------SSS----SSS--
---------------------|||||||||-----------------------------------------%-|----------o-----oo------------------%%-------------||-----------------------
---------------------|||||||||-------------------------------------------|----------------------oo-------------|----%%%------||---------r-------------
-----------------%%%%|||||||||------g-g------------------------------oo-%%%%-----------------------------------|%----|-------||-----%%%%%%%-----------
------------------||-|||||||||--%%%%%%%-----------------------%---------|||----------------SSS-----------------|-----|-------||------|||||------------
------------------||-|||||||||---|||||-----------------------r-----------------------------------------%%%%%%%-|--o--|-------||------|||||------------
XXXXXXXXXXXXXXX---||-|||||||||---|||||----oo-----------%%%%%%%------------------------------------------|||||--|-%%%-|---------------|||||------------
XXXXXXXXXXXXXXX---||-|||||||||---|||||------------------||||||---------------------%%%%%%%%---SS--------|||||-----|--|---------------|||||------------
