----------------------------------------------------------------------------------------------------------------------------------------------------------------------------------------------------------------------------------------------------------------------------------------
----------------------------------------------------------------------------------------------------------------------------------------------------------------------------------------------------------------------------------------------------------------------------------------
----------------------------------------------------------------------------------------------------------------------------------------------------------------------------------------------------------------------------------------------------------------------------------------
----------------------------------------------------------------------------------------------------------------------U-----------------------------------------------------------------------------------------------------------------------------------------------------------------
----------------------------------------------------------------------------------------------------------------------------------------------------------------------------------------------------------------------------------------------------------------------------------------
-----------------------------------------------k-k------------------------------------------------------------------------------------------------------------k---------------------------------------------------------------------------------------------------------------k---------
---------------------LSSS---------------------!!!!S-----------USSS--------SSCSS------SSSS----------------------------------------------S---------------------------------------------------------------------------!--------------------------------------------------------g##---------
------------------------------------------------------------------------------------------------------------------------SS------------------------------------------------------------oooo------------oooo-----------------------------------------------------------------g###---------
-----------------k---------------------------------------------------------------------------------------------------------k----------#-----------------------------------------------------------------------------------------------------------------------------------g####---------
-----------------#------------------------------k-----------------------------------------------g-------------------SS------##-------##---------------------------------oooo------------------------------------------------------------------------------------K-----k---#####---------
--------SUS-----##---2-----#-----------TT-----@!!-!----------S-----TT----!!!--!!!---------------TT-------------------------###------###--------------------------------------------TT--------------TT------------!!@S---------------oo---------------------------#----#--######---------
---------------###---------#-----------TT--------------------------TT--------------------k------TT----------#----B--------####-----####-------------------------------k------------TT--------------TT-----------------------------------#-------------------------------#######---------
--------------####---------##----------TT--------------------------TT---------------------------TT----------#----b-------#####---k#####---------------------k---------kT-----------TT--------------TT-----------------------------------r------TT----------------------########--k-k---F
--M----------#####----kk---##---yg-----kT--k----kk---gg----kkggg---TT------------ggg-------------T-----k--rkr#---B------######---#######-----kr-ggg-##-kkk---kkkkkk-k--T-----------TT-r-y-----ky---TT-----------------------k-k-kkkk----k------TT-k---r--r-gg---------#########-----k--#
XXXXXXXXXXXXXXXXXXXXXXXXXXXXXXXXXXXXXXXXXXXXXXkXXXXXXXXXXXXXXXXXXXXXXXXXXXXXXXXXXXXXX----XXXXXXXXXX---XXXXXXXXXXXkXXXXX-XXXXXXXXXXXXXXXXXXXXXXXXXXXXXXXXXXXXXXXXXXXXXXXXXXXXXXXXXXXXXXXXXXXXXXXXXXXXXXXXXXXXXXXXXXXX--XXXXXXXXXXXXXXXXXXXXXXXXXXX--rXXrXXXXXXXXX-----XXXXXXXXXXXXXXXXXXX
XXXXXXXXXXXXXXXXXXXXXXXXXXXXXXXXXXXXXXXXXXXXXXXXXXXXXXXXXXXXXXXXXXXXXXXXXXXXXXXXXXXXX----XXXXXXXXXX---XXXXXXX-XXXXXXXXX-XXXXXXXXXXXXXXXrXXXXXXXXXXXXXXXXXXXXXXXXXXXXXXXXXXXXXXXXXXXXXXXXXXXXXXXXXXXXXXXXXXXXXXXXXXXX--XXXXXXXXXXXXXXXXXXXXXXXXXXX--XXXXXXXXXXXXX------XXXXXXXXXXXXXXXXXX
