------------------------------------------------------------------------------------
------------------------------------------------------------------------------------
------------------------------------------------------------------------------------
-------------------------------------------------------------------SSSS-------------
--------------------------------------------------------------o---------------------
--------------------------------------------oo---%%%%--------SSS--------------------
---------------SSS-----------------SSS------SS----||-------------------SSSS---------
--------------------------------------------------||--------------------------------
--------------------------------------------------||--------------------------------
----%%%%%%--------------%%%%%%-----------------SS-||%%%%%%%%%----------------------F
-----||||----------------||||---------------------||-|||||||-----------------------#
-----||||----------------||||---------------------||-|||||||---------------XXXXXXXXX
--M--||||----------------||||---------------------||-|||||||---------------XXXXXXXXX
%%%%-||||-%%%%%%----%%%%-||||-%%%%%%----%%%%-----%%%%|||||||------------------------
-||--||||--||||------||--||||--||||------||-------||-|||||||------------------------
-||---------------------------------------------------------------------------------
