-------------------------------------------------------------------------------------------------------------------------------------------------------------------------------------------------------------------------------------------------------------------------------------------------------------------------------------------------------------------------------------------g--------------------
----------------------------------------------------------------------------------------------------------------------------------------------------------------------------------------------------------------------------------------------------------------------------------------------------------------------------------------------------------------------------------------------------------------
-----------------------------------------------------------------------------------------------------------------------------------------------------------------------------------------------------------------------------k----------------------------------------------------------------------------------------------------------------------------------------------------------------------------------
-------------------------------------------------------------------------------------------------------------------g--------------------------------------------------------------------------------------------------------------------------------------------------------------------------------------------------------------------------------------------------------------------------------------------
---------------------------------------------------------------------------------------------------------------------------------------------------------------------------------------------------------------------------------------------------------------------------------------------------------------------------------------------------------------------------------g------------------------------
------------------------g--------------------------k------------------------------------------g------------------k--------------------------------------------------------------------------------------------------------------------------------------oo----------------------------------------------------------------y-------------------------------------------------------------------------------------
---------------------LSSS-----------------------------------------------------------------------------------SSSSCSSS-----------------------------------------------------------------------------------------------------------------------------------SSS----------------------------------------------------------------##-------------------------------SSSSCSSS---------------------------------------------
-------------------------------------------------------------------------------------------------------------------------------------------g-----------------------------------------------------------------------------------------------------------------------------------------------------------------------------###----------------------g-------------------------------------------------------------
-----------------g--------------------@-----------g--------------------------------------------------g-----------------------------------------------------------------------TT---------------------------------------------------g---##--------------------------------------------------------------------------------####--------------g-------#-------------------------------------------------------------
-----------------#------k-------------------------------------oooo-----------------------------------------------k------------------------SSUSSSSS---------------------------TT---------------------------------------------------g--###------------------SSS-------------------------tt------------------------------g#####----------------k-----#--------------------------------------SSUSSSSS--------------g
--------SUS-----##---2-----#-----------------------ooo-----------------------------------ooo---------------#----2----#----------------------------------------------#LSS-----##---------------------------------------------------#--###-------@@@@@-D----------------------------TT--tt------------------------------######---S---------SCSSS----#-------#----2----#-------------------------------------------
--------------g###---------#------------------------------------------------------------------TT-----------#------K--#-------K--------------------------------------------------g----------g----------------g-----------TT------g##--###--------------------------------------TT--TT--tt-----------------------------#######---------------K-----##-------g------K--#-------K-----------------------------------
--------------####---------##-----#---#--------------------------------------------k----------TT-----------#---------#-----------K----------------------------------#-----------B---TT-----B-----TT---------TT----------TT------###--###--------------------------------------TT--TT--tt----------------------------########---------------------##-----------------#-----------K-------------------------------
--M----------#####----kk----#---g-T---#-------k-kkk----kkk---------kkk-------kk----g------g---gT-g--g-ggg--#--gg-gk--#--------------------g----------k--------kk-gkkk-----------b---TT-g--gb---g-TT---------TT--g-------TT---g-####--###-----------K-g--g-gog------------ggg-kTT--TT--tt-----k--ggg-----ggg-----gkgg########-------------k--kK---##-------#-g-------#-------------------------------k-----------
XXXXXXXXXXXXXXXXXXXXXXXXXXXXXXXXXXX---X--XXXXXXXXXXXXXXXXXXXXXXXXXXXXXXXXXXXXXXXXXXXXXXXXXXXXXXXXXXXXXXXXXXXXXXXXXXXXXXXXX-X-XX-X-XX-XXXXXXXXXXXXXXXXX-X-X-XXXXXXXXXXXXXX---XXXXXXXXXXXXXXXXXXXXXXXXXXXX-XXXXX-X------XXXXXXXXXXXXX--XXXXXXXXXXXXXXXXXXXXXXXX----XXXXXXXXXXX-XX--XX--XXXXXXXXXXXXXXXXXXXXXXXXXXXXXXXXXXXXXXXXXXXX-XXXXXXXXXXXXXXXXX---XXXXXXXXXXXXXXXXXXX-X-XX-X-XX-XXXXXXXXXXXXXXXXX-X-X-XXXXXX
XXXXXXXXXXXXXXXXXXXXXXXXXXXXXXXXXXX---X--XXXXXXXXXXXXXXXXXXXXXXXXXXXXXXXXXXXXXXXXXXXXXXXXXXXXXXXXXXXXXXXXXXXXXXXXXXXXXXXXX-X-XX-X-XX-XXXXXXXXXXXXXXXXX-X-X-XXXXXXXXXXXXXX---XXXXXXXXXXXXXXXXXXXXXXXXXXXX-XXXXX-X------XXXXXXXXXXXXX--XXXXXXXXXXXXXXXXXXXXXXXX----XXXXXXXXXXX-XX--XX--XXXXXXXXXXXXXXXXXXXXXXXXXXXXXXXXXXXXXXXXXXXX-XXXXXXXXXXXXXXXXX---XXXXXXXXXXXXXXXXXXX-X-XX-X-XX-XXXXXXXXXXXXXXXXX-X-X-XXXXXX
