-----------------------------------------------------------------------------------------------------------------------------------------------------------------------------------------------------
-----------------------------------------------------------------------------------------------------------------------------------------------------------------------------------------------------
-----------------------------------------------------------------------------------------------------------------------------------------------------------------------------------------------------
-----------------------------------------------------------------------------------------------------------------------------------------------------------------------------------------------------
-----------------------------------------------------------------------------------------------------------------------------------------------------------------------------------------------------
-------------------------------------------------------------------g--------------------r------------------------------------------------------------------------------------------------------------
---------------------LSSS-------------------------------SSCCCCCCCCSSSS---SSSS--SSSSSSSSSSSSS----------------------------------------------------------------------------------------------##---------
---------------------------------------------------------------------K---------------------------------------------------------------------------oooo------------------------------------###---------
-----------------g----------------------------------------------------------------------------------------------------------------------------------------------------------------------####---------
-----------------#-------------------------1-------------------------------------------k-k----#----------------------------------------------------------------------------------------#####---------
--------SUS-----##---2-----#-----------TT-----------------@SSSSSSSSSS--#C--------------CCCCCCC#---------------------------------------------------------------------------------------######---------
---------------###---------#-----------TT-----------------------------##--------------------------------------------------------------------------TT---------------------------------#######---------
--------------####---------##----------TT----------------------------###--------------------------------------------------------------------------TT--------------------------------########--------F
--M----------#####----kk---##---gg-----TT-----gg--------------------####----------#-----kk------------gg-------------kkk-------kk----------kkk----TT----k---ggg-------ggg------ggg-#########--------#
XXXXXXXXXXXXXXXXXXXXXXXXXXXXXXXXXXXXXXXXXXXXXTTXXXXXX---XXXXXXXXXXXXXXXXXXXX------XXXXXXXXXXXXXXXXXXXXXXXXXXXXXXXXXXXXXXXXXXXXXXXXXXXXXXXXXXXXXXXXXXXXXXXXXXXXXXXXXXXXXXXXXXXXXXXXXXXXXXXXXXXXXXXXXXX
XXXXXXXXXXXXXXXXXXXXXXXXXXXXXXXXXXXXXXXXXXXXXTTXXXXXX---XXXXXXXXXXXXXXXXXXXX------XXXXXXXXXXXXXXXXXXXXXXXXXXXXXXXXXXXXXXXXXXXXXXXXXXXXXXXXXXXXXXXXXXXXXXXXXXXXXXXXXXXXXXXXXXXXXXXXXXXXXXXXXXXXXXXXXXX
