----------------------------------------------------------------------------------------------------------------------------------------------------------------------------------------------------------------------------------------------------------------------------------
----------------------------------------------------------------------------------------------------------------------------------------------------------------------------------------------------------------------------------------------------------------------------------
----------------------------------------------------------------------------------------------------------------------------------------------------------------------------------------------------------------------------------------------------------------------------------
----------------------------------------------------------------------------------------------------------------------------------------------------------------------------------------------------------------------------------------------------------------------------------
----------------------------------------------------------------------------------------------------------------------------------------------------------------------------------------------------------------------------------------------------------------------------------
-----------------------------------------------------------------------------------------------------------------------------------------------------------------------------------------------------------------------------------------------------------------------##---------
---------------------LSSS---------------------!!!!!-----------USSS------------------------------------------------------------------------------------------------------------------------------------------------------------------------------------------------K----##---------
-------------------------------------------------------------------------------------S1SSSSSSSSSSSSSSSSSSSSSSSSSSSSSSSSSSSSSSSSSSSSSSSS--------------------------------------------------------------------------------------------------------------------------------##---------
-----------------g--------------------------------------------------------------------------------------------------------------------------------------------------------------------------------------------------------------------------------g#----------------#--##---------
-----------------#------------------------------k---------------------------------------------------------------------------------------------------------------------------------B---------------------------------------------------K-----------##----------------#--##---------
--------SUS-----##---2-----#-----------TT-----@!!!!----------S-----TT---!!!!----------------------------------------------------------------------------------S@---------SS------S#2---------------------------------TT---------K---------------g###----B---------#-#--##---------
---------------###---------#-----------TT--------------------------TT---------------------------K---------K--K------------K--K----------SS--------------B-------------------------------B----------------------------TT-----TT-----K----B-------####----b--------##-#--##--------F
--------------####---------##----------TT--------------------------TT-----------------#---------------------------------------------------------B-----K-bK----------B-------------------b-----TT----K----TT----------TT-----TT----------b------#####-y--B-------###-#--##--------#
--M----------#####----kk---##---gg-----TT------------gg----k-ggg---TT-----------------#---------------------------------------------------------b-------B-----------b--y------B--y-y----b-----TT---------TT--------XXXXXXXXXXXXXXXXXXXX-X---XXXXXXXXXXXXXXXXXXXXXXX-X--XXXXXXXXXXX
XXXXXXXXXXXXXXXXXXXXXXXXXXXXXXXXXXXXXXXXXXXXXXXXXXXXXXXXXXXXXXXXXXXXXXXXXXXXXX-XXXXXXXX-XXXX-X-XXX-XXXXXX-XXXXXXXXXXXXXXX-XXXXXXXXXXXXXXX--XXXX-XXXXXXXXXXXXXXXXXXXXXXXXXXXXXXXXXXXXXXXXXXXXXXXXXXXXX-XXXXX-X------XXXXXXXXXXXXXXXXXXXX-X---XXXXXXXXXXXXXXXXXXXXXXX-X--XXXXXXXXXXX
XXXXXXXXXXXXXXXXXXXXXXXXXXXXXXXXXXXXXXXXXXXXXXXXXXXXXXXXXXXXXXXXXXXXXXXXXXXXXX-XXXXXXXX-XXXX-X-XXX-XXXXXX-XXXXXXXXXXXXXXX-XXXXXXXXXXXXXXX--XXXX-XXXXXXXXXXXXXXXXXXXXXXXXXXXXXXXXXXXXXXXXXXXXXXXXXXXXX-XXXXX-X---------------------------------------------------------------------
