-----------------------------------------------------------------------------------------------------------
-----------------------------------------------------------------------------------------------------------
-----------------------------------------------------------------------------------------------------------
-----------------------------------------------------------------------------------------------------------
------------------------------------------------------------------------------------------------K----------
-----------------g-----------------------------------------------------------------------------------------
---------------SSSSSSSS---SSS!--------------@-----------SSS----S!!S-----------------------------##---------
-----------------------------------------------------------------------------------------------###---------
--------------g-------------------------------------------------------------------------------####---------
---------------------------------------------------------------------------------------------#####---------
------------S@S--------------C-----SU----!--!--!-----S----------SS------#--#----------##--########---------
-------K---------------------------------------------------------------##--##--------###--########---------
----------------------------------------------------------------------###--###------####--########--------F
--M---------------------------g-g--------k-----------------gg-g-g----####--####----#####--########--------#
XXXXXXXXXXXXXXXXXXXXX---XXXXXXXXXXXXXXXXXXXXXXXXXXXXXXXXXXXXXXXXXXXXXXXXXXXXXXXXXXXXXXXX--XXXXXXXXXXXXXXXXX
XXXXXXXXXXXXXXXXXXXXX---XXXXXXXXXXXXXXXXXXXXXXXXXXXXXXXXXXXXXXXXXXXXXXXXXXXXXXXXXXXXXXXX--XXXXXXXXXXXXXXXXX
