--------XXXX--r#-------rXXX-g--------------------------#--r-----------------------------TT-----#--------------r---------------#-#--##-----rr-XX-XXr-----TT--rrrrr--g--rk-rrr--r-----r--r----------r----rrrrr-r--rrr---b------------XXXXb----r-----------r------rS---K---------------------------------------------------------------------r--------#--------r-XXXXXX---X---XXXXXXXX---XX-X--XX-XXXXXXXX--XXX----
---------XXX--XXXXXXXXXXXXXXXX--------r-----r----------#--------------------------------TT-----#-----------------------------##-#--##---XXXXXXX-XXXXXX--TTXXXXXXXXXXXXXXXXXXXXXXXXXXXXXXXX-----XXXXXXXXXXXXX-XXXXXr-XXXXX-X---XXXX-XXXXXXXX-------------XXXXXXX----------------------S----------r-----------------------------------------T--------#-rXXXXXXXXX--------XXXXXXXXXXXX---XX-X--XX------------------
--------------XXXXXXXXXX---XXXr--XXXXXXXX-XXXX-Xr------#r-r-r-r--*----r---r--rXrr-rr--grTTr----#----r----rr-----r---------r-###r#--##--XXXXXX-----XXXX----XXXXXXXXXXXXXXXXXXXXXXXXXXXXXXXXX--XXXXXXXXXXXXXXX-XXXXX--XXXXX-X---XXXX-----XXXXr-----------XXXXXXXXr-----r---r--r--gg---#----------##----------@@@@@@-------------------------T-------XXXXXXXXXXXX----------XXX-------------------------------------
---------------------------------XXXXXXXX-XXXX-XX-B----XXXXXXXXXXXXXXXXrXXXXXXX-XXXXXXXXXX-XXXXX--XXXXXXXXXXXXXXXXXX------r-XXX-X--XXXXX-----------------------------------------------------XXr---------------------------r-------------------------XXX----------XXXXXXXXXXXXXXXX-----r------###-----#------------------------------r----T-----kXXXXX----------------------------------------------------------
-------r----------------r-------r---------------XXb-X--XXXXXXXXXXXXXXXX-XXXXXX--XXXXXXXXXX-XXXXX--XXXXXXXXXXXXXXXXXXr--XXXXXXXX-X--XXXX------r-----------------------------------------------------------------------------------------------X----XX-XX----------XXXXXXXXXXXXXXXXXrX---------#####----#-------------------------r---rrrr--TXXXXXXX--r---------r--------r---r----------r----------------r--------
-------------------------------------r-----------XXXX------------------------------------------------------------------XXXXX----------------------------------------------r----r------------------------r-----r------------------------r-----X----XXr------------X-----------------X---XXX--#######---#----K---rr----r--ggg--XXXXXXXXXXXXXXXXXXXX-------------------r---------------------------------------r-r-
-------CS-----------------------------------------XX------------------------------------r------------------------------------------------------------------------------------------------------------rr-----r------------------------------r---r----------------------------------r----XXXrXXXXXXXXX--XXXXXXXXXXXX-XXXXXXXXXXXXXXXXXXXXXXXXr---------------------------------------r----------r------------r-SSS
-------------------------r----------------------r------------------------------------------r---------------------------------------------------------------r----------------------------------------------------------------------r------------------r-------------------------------------XXXXXXXXX--XXXXXXXXXXXX-XXXXXXXXXX----------------------------------r--2-----------------------------------------S---
-------rr----------------S---------------------------------------------r-------r-------------------r---------r-------------------------rr-r-----------r-----r----------------------------------r--r---------------------------r---------r---------------r---r------------------------------------------------------------------------------------------r---------------------------r---rr-----------------------
-----r---r-----------------r-----r------r-r----r--r--------------------------------------------------------------------------------------SS---------2-------S-----r------------------r---2-----r-SS------r------S---------r-------------r-rr-----------r---SSSSS-------------------------------------------------------------r--------------------------SSS-----------------------------------------------------
-----S@SSS------------------------------2CS-S---------------------------r---------------r-----------------------------------r------------------------------o------------------------------------S----------------------------r-----------SS--r--------------r--------rrr---------r---------------------------------------------------------------r-----------------2----------------------------------r---------
-------------------------------------------S--------r-----------------------2--------------------------------r--r-------------------##--------------------o-------------------------------r-----------------------------------------------------------------------r----------------r-------------------------------------------------------r------!------r----------------------------------r-------------------
---------------@-----------------------------------------------------------------------------r--------------------------------------##---------------2--------r---------------------------2-----------------r----r----------------------------------rr--------K--!----r------------------------------r---------------------------r--------------------------------------r---SU----------------------------------
--M---r-----------------------------------------------------------------------------------------------------------------------------##-----r-------------r-------------@@------------------r-----------------r--S@@--------S-------------------r-r-r-------SSSSSS-----------------------r------------------------rr------r------------------------------SSS-------------#---------------------B--------#--------
XXXXXXXXXr-----------K-----r-------------2-----------------------------------2-----------T---------------------------------------#--##---------K--r------T--------------------------K---------------------------------------SS-----------K-----------------------------------------------------------------2--------------rr------------------------#----r------rr----r-#-------r------r------b-----r--#---r-XXX
XXXXXXXXXX-r--------------r-----------------------------#----------------------r---------TT---------------------S@@@-------------#--##-------r-----------Tr---------------------r----------r-------r-------------------B-------------rr-B------------------------y----r---------------------r----------------------------rSSS---------------------@-#-----------XXXXX---#-----r-r--r----------B-XXXXXXXX--XXXXXX
