---------------------------------------------------------------------------------------XXXXXX---XXXXXXXXXX--XXXXXXXXXXXXXXXXXXXXXXXXXXXXXXXXXXXXXXXXXXXXXXX-
------------------------------------------------------------------------------------------------XXXXXXXXXX--XXXXXXXXXXXXXXXXXXXXXXXXXXXXXXXXXXXXXXXXXXXXXXX-
------------------------------------------------------------------------------------------------------------------------------------------------------------
------------------------------------------------------------------------------------------------------------------------------------------------------------
------------------------------------------------------------------------------------------------------------------------------------------------------------
--------------------------------------------------------------g---------------------------------------------------------------------------------------------
------------------SCS-----------------------------------------SSSSS-----SSSSS--------------------------------------------------------------------XX---------
---------------------------TT--------------------------------------------------------ooUSS-------------------------------------------------------XX---------
---------------------------TT----------------------------TT------------------------T-----------------------------------SSSSS---@-------------C---XX---------
---------------------------XX----------------------TT----TT-----------------------TT-------------------------------------------------------------XX---------
-----SSS------TT---2---TT----------------TT---SU---TT----XX------------------2----TT-------------------------------------------------------------XX---------
--------------TT-------TT-------------K--TT--------TT----------------------TT-----TT-------------------------------------------------------------XX---------
--------------TT-------TT-----TTTT-------TT--------TT---------TT-----tt----TT--TT-TT--------------------------------C--------!--------------SS---XX---------
--M-----------TT----k--TT-----TTTT-------TT------k-TT---------TT-----tt----TT--TT-TT---y---------------------#---------------------TT------------XX---------
XXXXXXXXXXXXXXXXXXXXXXXXXXXXXXXXXXXXXXXXXXXXXXXXXXXXXXXXXXXXXXXXXXXXXXXXXXXXXXXXXXXXXXXX---ggg-----------K---#---------------------TT------------XX--------F
XXXXXXXXXXXXXXXXXXXXXXXXXXXXXXXXXXXXXXXXXXXXXXXXXXXXXXXXXXXXXXXXXXXXXXXXXXXXXXXXXXXXXXXXXXXXXX---------------#-----gg-------K-K----TT--------k---XX--------X
