----------------------------------------------------------------------------------------------------------------------------------------------------------------------------------------------------------------------------------------------------------------------------------------------------------------------------------------------------------------------------------------------------------------
----------------------------------------------------------------------------------------------------------------------------------------------------------------------------------------------------------------------------------------------------------------------------------------------------------------------------------------------------------------------------------------------------------------
----------------------------------------------------------------------------------------------------------------------------------------------------------------------------------------------------------------------------------------------------------------------------------------------------------------------------------------------------------------------------------------------------------------
----------------------------------------------------------------------------------------------------------------------------------------------------------------------------------------------------------------------------------------------------------------------------------------------------------------------------------------------------------------------------------------------------------------
----------------------------------------------------------------------------------------------------------------------------------------------------------------------------------------------------------------------------------------------------------------------------------------------------------------------------------------------------------------------------------------------------------------
------------------------------------------------------------------oo---------------------------------------------------------------------------------------------------------------------------k--------------------------------------------------k-----------------------------------------------------------------------------------------------r-------------------------------------------------------------
---------------------LSSS----------------------------------------SSS-------------------------------------------------------------SSSSS----------------------------------------------------S---SSSSSS---SSSSS---------------------------------S---SSSSSSSSS------------US---SS-------------SSS------------------!!!!!-----------USSS--------SSCSS-CSSSS----------------------------------------------------------
--------------------------------------------------------------------------------------------------------------------------------------------------------------------------------------TT-------------------------------------------------TT------------------------------------------------------------------------------------------------------------------------------------------o--------------------@-----
-----------------g------------------------------##--------------------------------------------------------B---------------------------------------------------------------------------TT-------------------------TT----------------------TT---------------------------------------------------------------------------------------------------------------------------------------------------------------------
-----------------#-----------------------------###------------------SSS-------------------------tt--------b-----------------------K--------------oo---------------------tt------------TT-------------------------TT----------------------TT-------------------------SS-------------------------------------------k---------------------------------k----#----------------o--------------------------------------
--------SUS-----##---2-----#----------------#--###-------@@@@@-D----------------------------TT--tt-------S#CS--------------------SSSSS------------------------------TT--tt------------XXS-------------------2----TT-------------tt------SXXS------------------------------SSS---------#---SSS-----------TT------!!!!----------S-----TT---!!!!--!!CCCCCCC#--------------------------------------------ooo--------
---------------###---------#------TT------g##--###--------------------------------------TT--TT--tt----------------------------------K---#-----------------------TT--TT--tt--------------------------------TT-----TT-----TT------tt-----------------------------------------------#-TT-#-----------------TT--------------------------TT--------------------------------------------------------------------#-----
--------------####---------##-----TT------###--###--------------------------------------TT--TT--tt----------K-B-----KB-----TT----K------#-----------------------TT--TT--tt----------------TT--------------TT--TT-TT-----TT------tt-TT--------TT--------------TT--TT-------------##-TT-##----------------TT--------------------------TT---------------------------------------K----------------------------#-----
--M----------#####----kk---##-----#T---g-####--###-----------K------oo-------------ggg--TT--TT--tt------------b-----Kb-----TT-----------#----B-------------ggg--TT--TT--tt-------b--------TT---------------T--TT-TT---k-TT------tt--T--------TT--------------TT--TT------------###-TT-##---------gg-----#T------------gg----k-ggg---TT------------kk------------gg-------------kkk-------kk----g----------#-----
XXXXXXXXXXXXXXXXXXXXXXXXXXXXXXXXXXXXXXXXXXXXX--XXXXXXXXXXXXXXXXXXXXXXXX----XXXXXXXXXXX-XX--XX--XXXXXXXXXXXXXXXXXXXXXXXXXXXXXXXXXXXXXXXXXXXXXXX------XXXXXXXXXX-XX--XX--XXXXXXXXXXXXXXXXXXXXXXXXXXX---XXXXXXXXXXXXXXXXXXXXXXXXXXXXXXXXXXXXXXXXXXXXXXXX------XXXXXXXXXXXX-X-XXXXXXXX-XXXXXXXXXXXXXXXXXXXXXXXXXXXXXXXXXXXXXXXXXXXXXXXXXXXXXXXXXXXXXXXXXXXXXXXXXXXXXXXXXXXXXXXXXXXXXXXXXXXXXXXXXXXXXXXXXXXXXXXXXXXXX
XXXXXXXXXXXXXXXXXXXXXXXXXXXXXXXXXXXXXXXXXXXXX--XXXXXXXXXXXXXXXXXXXXXXXX----XXXXXXXXXXX-XX--XX--XXXXXXXXXXXXXXXXXXXXXXXXXXXXXX-XXXXXXXXXXXXXXXX------XXXXXXXXXX-XX--XX--XXXXXXXXXXXXXXXXXXXXXXXXXXX---XXXXXXXXXXXXXXXXXXXXXXXXXXXXXXXXXXXXXXXXXXXXXXXX------XXXXXXXXXXXX-X-XXXXXXXX-XXXXXXXXXXXXXXXXXXXXXXXXXXXXXXXXXXXXXXXXXXXXXXXXXXXXXXXXXXXXXXXXXXXXXXXXXXXXXXXXXXXXXXXXXXXXXXXXXXXXXXXXXXXXXXXXXXXXXXXXXXXXX
