-------------------------------------------------------------------------------------------------------------------------------------------------------------------------
-------------------------------------------------------------------------------------------------------------------------------------------------------------------------
-------------------------------------------------------------------------------------------------------------------------------------------------------------------------
-------------------------------------------------------------------------------------------------------------------------------------------------------------------------
-------------------------------------------------------------------------------------------------------------------------------------------------------------------------
-------------------------------------------------------------------------------------------------------------------------------------------------------------------------
-----------------------------US-------------------------------------------------------------------------------------------------------------------------------##---------
-------------------------------------------------------------------------------------------------------------------------------------------------------------###---------
----------------------------------------------------------------------------------#-------------------------------------------------------------------------####---------
---------------------------------------------------------------------------------##--oo------o----o--------------------------------------------------------#####---------
---------!!-----------------####--SSC-------------------------------------------###--------------------------------------##--#------------SS!S------------######---------
-----------------------y-#####--------------g---K------------------------------####-------------------------------------###--##--------------------------#######---------
--------------------y-######----------------TT--------------#-----------------#####----------------------#---#---------####--###-----tt--------------tt-########--------F
--M----------------#######------------------TT-----k----ggg-#--------------gg######--k-------------------#-k-#--------#####--####----tt---------gg---tt#########--------#
XXXXXXXXXXXXX--XXXXXXXXX------XX--XXXXXXXXXXXXXXXXXXXXXXXXXXXXXXXXXXXXXXXXXXXXXXXXXXXXXXXXX---XX---XXXXXXXXXXXXXXXXXXXXXXXX--XXXXXXXXXXXXXXXXXXXXXXXXXXXXXXXXXXXXXXXXXXXX
XXXXXXXXXXXXX--XXXXXXXXX------XX--XXXXXXXXXXXXXXXXXXXXXXXXXXXXXXXXXXXXXXXXXXXXXXXXXXXXXXXXX---XX---XXXXXXXXXXXXXXXXXXXXXXXX--XXXXXXXXXXXXXXXXXXXXXXXXXXXXXXXXXXXXXXXXXXXX
