-----------------------------------------------------------------------------------------------------------------------------------------------------
-----------------------------------------------------------------------------------------------------------------------------------------------------
-----------------------------------------------------------------------------------------------------------------------------------------------------
-----------------------------------------------------------------------------------------------------------------------------------------------------
-----------------------------------------------------------------------------------------------------------------------------------------------------
--------------------------------------------------------------g---------------------------------------------------------------------------k----------
------------------SCS-----------------------------------------SSSSS-----SSSSSS-------------------------r----------------------------------##---------
---------------------------TT-----------------------------------------------------------------------SSSSS--------------CCSS--------------###---------
---------------------------TT----------------------------TT-----------------------------------------------------------------------------####---------
---------------------------XX----------------------TT----TT----------------------------------------------------------------------------#####---------
-----SSS------TT---2---TT----------------TT---SU---TT----XX------------------------------@-------------------------@------------------######---------
--------------TT-------TT-------------K--TT--------TT----------------------TT---------KK------SSS---------------KK------------------g#######---------
--------------TT-------TT-----TTTT-------TT--------TT---------TT-----tt----TT-------------------------------------------TT----------########--------F
--M-----------TT----k--TT-----TTTT-------TT------k-TT---------TT-----tt----TT-------------------------gg----------------TT---------X########--------#
XXXXXXXXXXXXXXXXXXXXXXXXXXXXXXXXXXXXXXXXXXXXXXXXXXXXXXXXXXXXXXXXXXXXXXXXXXXXX--XXXXXXXXXXXX-------XXXXXXXXXXXXXXXXXXX---XX--XXXXXXXXXXXXXXXXXXXXXXXXX
XXXXXXXXXXXXXXXXXXXXXXXXXXXXXXXXXXXXXXXXXXXXXXXXXXXXXXXXXXXXXXXXXXXXXXXXXXXXX--XXXXXXXXXXXX-------XXXXXXXXXXXXXXXXXXX---XX--XXXXXXXXXXXXXXXXXXXXXXXXX
