-------------------------------------------------------------------------------------------------------------------------------
-------------------------------------------------------------------------------------------------------------------------------
-------------------------------------------------------------------------------------------------------------------------------
-------------------------------------------------------------------------------------------------------------------------------
-------------------------------------------------------------------------------------------------------------------------------
--------------------------------------------------------------------------------------------------------------------@#---------
---------------------LSSS------------------------!!!!---------------------------------------------------------------##---------
------------------------------------------------------------------------------------------------------------------y###---------
-----------------g------------------------------------------------------------------------------------------------####---------
-----------------#---------------------------------y-------------------------------------------------------------#####---------
--------SUS-----##---2-----#-----------TT------!!@SS!!!---------------------------------------------------------######---------
---------------###---------#-----------TT-------------------------------------------------#--------------------#######--------F
--------------####---------##----------TT-----------------------TT------------------------#-------------------########--------#
--M----------#####----kk---##---gg-----TT-----------------------TT------------------------#----y--y----------########XXXXXXXXXX
XXXXXXXXXXXXXXXXXXXXXXXXXXXXXXXXXXXXXXXXXXXXXXXXXX--XXXXXXXXXXXXXXXXXXXXXXX---XXX--XXXXXXXX--XXXXXXXXXXXXXXXXXXXXXXXXXXXXXXXXXX
XXXXXXXXXXXXXXXXXXXXXXXXXXXXXXXXXXXXXXXXXXXXXXXXXX--XXXXXXXXXXXXXXXXXXXXXXX---XXX--XXXXXXXX--XXXXXXXXXXXXXXXXXXXXXXXX----------
