----------------------------------------------------
----------------------------------------------------
----------------------------------------------------
----------------------------------------------------
----------------------------------------------------
----------------------------------------------------
---------------------LSSS----------------##---------
----------------------------------------###---------
-----------------g---------------------####---------
-----------------#--------------------#####---------
--------SUS-----##---2-----#---------######---------
---------------###---------#--------#######---------
--------------####---------##------########--------F
--M----------#####----kk---##---gg-########--------#
XXXXXXXXXXXXXXXXXXXXXXXXXXXXXXXXXXXXXXXXXXXXXXXXXXXX
XXXXXXXXXXXXXXXXXXXXXXXXXXXXXXXXXXXXXXXXXXXXXXXXXXXX
