-----------------------------------------------------------------------------------------------------------------------------------------------------------------------------------------------------------------------------------------------------------------------------------------------------------------X----------------------------------------------------------------------------------------------
----------------------------------------------------------------------------------------------------------------------------------------------------------------------------------------------------------------------------------------------------------------------------------------------------------------------------------------------------------------------------------------------------------------
----------------------------------------------------------------------------------------------------------------------------------------------------------------------------------------------------------------------------------------------------------------------------------------------------------------------------------------------------------------------------------------------------------------
--------------------------------------------------------------------------------------------------------------------------------------------------------------------------------------------------------------------------------------------------------------------------------------------------------------------------------------------------------------------------U-------------------------------------
----------------------------------------------------------------------------------------------------------------------------------------------------------------------------------------------------------------------------------------------------------------------------------------------------------------------------------------------------------------------------------------------------------------
--------------------------------------------------------------g-----------oo--------------------------------------------------------------------------------------oo-----------------------g----g-----------------------------------------------------------------g-------------------------------------------------------------------------------------------------------------------------------oo------------
------------------SCS-----------------------------------------SSSSS-----S----------------------------------------------------------------------------------------SSS-----------------------S-----SSSS-----SSSSS-------------------------------------SSCCCCCCCCCCCCSSS---SSCSSS---------------------------------------------------------------------------SSSSS-----------------------------------SSS------------
---------------------------TT----------------------------------------------------------------S----------------------------------------------------------------------------------------------------------------------------------------------------------------------K-------------------------------------------------------------------------------------------------------SS----------------------------------
---------------------------TT----------------------------TT-------------------------------------------------------------------------------------##------------------------------------------------------------------TT-----------------------------------------------------------------------------------------------------------------------------------------------------------#------------------------------
---------------------------XX----------------------TT----TT---------------------------------------------------------------------------------g--###------------------SSS---------------------------------------------TT-----------------1------------------------------------------------------------oSUSSSSSUSSUSS---------------------B------------------K-------------SS------##------------------SSS---------
------SS------TT---2---TT----------------TT---SU---TT----XX-------C--------------------------------------------------------------o----------#--###-------@@@@@-D------------------------------------C----------2----TT-------------tt-----------------@SSSSSSSSSSSSS--#C-------#----------------------------------------------SS------S#2----------------SSSSS-----------------###--------@@@@-D----------------
--------------TT-------TT-------------K--TT--------TT-----------------------------K-----------------------------------------------TT------g##--###-----------------------------------------T-----------------TT-----TT-----TT------tt--------------------------------##-----K--#-------K-----------------------------------------------------B--------------K---#----B--------####------------------------------
--------------TT-------TT-----TTTT-------TT--------TT---------TT-----tt----------------------#------------------------------------TT------###--###-----------------------------------------TT---TT-----tt----TT--TT-TT-----TT------tt-------------------------------###--------#-----------K-----------------------------B-------------------b-----TT----K------#----b-------#####------------------------------
--M------------T----k--TT-----TTTT-------TT------k-TT---------TT-----tt---ggg----------gg----#-------k-----kkk-------kk----#------TT-----####--###-----------K------oo--------------gg-T---TT---TT-----tt----TT--TT-TT---k-TT------tt-T---gg-----------------------####--------#--------------------------------------------y------B--y-y----b-----TT-----------#----B------######---##------K------oo----------
XXXXXXXXXXXXXXXXXXXXXXXXXXXXXXXXXXXXXXXXXXXXXXXXXXXXXXXXXXXXXXXXXXXXXXXXXXXXXXXXXXXXXXXXXX--XXX--XXXXXXXXXXXXXXXXXXXXXXXXXXXXXXXXXXXXXXXXXXXX--XXXXXXXXXXXXXXXXXXXXXXXX----XXXXXXXXXXX-TTXXXXXXXXXXXXXXXXXXXXXXXXXXXXXXXXXXXXXXXXXXXXXXXXTTXXXXXX---XXXXXXXXXXXXXXXXXXXXXXXXXXXXXXXX-X-XX-X-XX-XXXXXXXXXXXXXXXXXXXXXXXXXXXXXXXXXXXXXXXXXXXXXXXXXXXXXXXXXXXXXXXXXXXXXXXXXXXX-XXXXXXXXXXXXXXXXXXXXXXXXXXX----XXXXX
XXXXXXXXXXXXXXXXXXXXXXXXXXXXXXXXXXXXXXXXXXXXXXXXXXXXXXXXXXXXXXXXXXXXXXXXXXXXXXXXXXXXXXXXXX--XXX--XXXXXXXXXXXXXXXXXXXXXXXXXXXXXXXXXXXXXXXXXXXX--XXXXXXXXXXXXXXXXXXXXXXXX----XXXXXXXXXXX-XTXXXXXXXXXXXXXXXXXXXXXXXXXXXXXXXXXXXXXXXXXXXXXXXXTTXXXXXX---XXXXXXXXXXXXXXXXXXXXXXXXXXXXXXXX-X-XX-X-XX-XXXXXXXXXXXXXXXXXXX-XXXXXXXXXXXXXXXXXXXXXXXXXXXXXXXXXXXXXXXXXXXXXXXXXXXXXXXX-XXXXXXXXXXXXXXXXXXXXXXXXXXX----XXXXX
