----------------------------------------------------------------------------------------------------------------------------------------------------------------------------------------------------------------------------------------------------------------------------------------------------------------------------------------------------------------------------------------------------------------
----------------------------------------------------------------------------------------------------------------------------------------------------------------------------------------------------------------------------------------------------------------------------------------------------------------------------------------------------------------------------------------------------------------
----------------------------------------------------------------------------------------------------------------------------------------------------------------------------------------------------------------------------------------------------------------------------------------------------------------------------------------------------------------------------------------------------------------
----------------------------------------------------------------------------------------------------------------------------------------------------------------------------------------------------------------------------------------------------------------------------------------------------------------------------------------------------------------------------------------------------------------
------------------------------------------------------------------------------------------------------------------------------------------------------------------------------------------------------------------------------------------------------------------------------------------------------------------------------------------------------------------------g---------------------------------------
------------------------------------------------------------------oo---------------------------------------------------------------------------------g--------------------------------------g-----g-----------------------g--------------------rg--------------------------------------------------------------------------------------------------------------------g-g----------g-----------------------------
---------------------LSSS----------------------------------------SSS---------------------------------------!-!------------------------------------------------USSS--------------------------SSCCCCCCSCCCCCCCCCCCCCCCCCCCCSSSS---SSSS--SSSSSSSSSSSSS-------------------------SUS-------------------------g-----------------------------------------------------------SSCCCCCCCCCCCCCCCCCCCkCCCCCCCCCCCCCCCCCCCCCC
----------------------------------------------------------------------------------------------------S---------------------------------------------------------------------------------g-------------------------------------K-----------------------------------------g--g-----------------------TT-------------------------------------------------------------------------------------------------------------
-----------------g----g-------------------------##-------------------g-------------------------------------------------g---------------g---------------------------g---------------------------g------------g--g------------------------------------------------------------------o--------------TT------g-----------------------g-----------------------------------------------------------g------g-----------
-----------------#---------g----------------g--###------------------SSS--------------oo----------------------------------------------------------------------------TT-------------------------------------------------g-----------------------k-k----#------------------------g------------------TT----------------------------------------------------1--------------------------------S---------------------k-
--------SUS2----##---2-----#----------------#--###-------@@@@@-D---------------------o-o-------------------!-!-----------------------!--------------g------TT------TT-------------------------@SSSSSSSSSSSSSSSSSSSSSSSSSSSSS--#C--------------CCCCCCC#---------------------#####-----------------XX-----TT-----g-TT---------------g##----------@---tt-----------------@SSSSSSSSSSSSSSSSSSSSSSSSSSSSSSSSSSSSSSSSS
---------------###---------#------gT------g##--###----------------------------------K-------------------------------------------------K-------------g------TT--tt--TT--------------------------------------------------------##------------------------------------------g-#----------------------------TT-----TTTT----TT---------###------Tg------tt-----------------------------------------------------------
--------------####---------##-----TT------###--###--------------------------------------------------------------------------------------B-----------TT-----TT--tt--TT------------------K------------------------------------###-----------------------------g--------------#---------------g------------TT---TTTTTT----TT--------#####-----TT------tt-----------------------------------------------------------
--M----------#####----kk-k-##---g-TT-g--g####--###-----------Kg-----go--g---------ggg-------g----y--g--------y-y------g-g----g------ggk-bgggg---kk-ggT-gg--TT--tt--kT-----k---------ggg-------k----------------------------####----------#--g--kk----k-------ggg-----gkgk--#----------#---ggg----g------TT---TTTTTT---gTT---g---######-----TT---g--tt-T-k-gg----------------------------------------------------
XXXXXXXXXXXXXXXXXXXXXXXXXXXXXXXXXXXXXXXXXXXXX--XXXXXXXXXXXXXXXXXXXXXXXX----XXXXXXXXXXXXXXXXXXXXXXXXXXXXXXXXXXXXXXXXXXXXXX----XXXgXXXXXXXXXXXXXXXXXXXXXXXXXgXXXXXXXXXXXXXXXXX---XXXXXXXXXX---XXXXXXXXXXXXXXXXXXXXXXXXXXXXXXXXXXXXXXX------XXXXXXXXXXXXXXXXXXXXXXXXXXXXXXXXXXXXX----XXXXXXXXXXX-XXXXXXXXXXXXXXXXXXXXXXXXXXXXXXXXXXXXXXXXXXXXXXXXXXXXXXXXXXXTTXXXXXX---XXXXXXXXXXXXXXXXXXXXXXXXXXXXXXXXXXXXXXXXXXXX
XXXXXXXXXXXXXXXXXXXXXXXXXXXXXXXXXXXXXXXXXXXXX--XXXXXXXXXXXXXXXXXXXXXXXX----XXXXXXXXXXXXXXXXXXXXXXXXXXXXXXXXXXXXXXXXXXXXXX----XXXXXXXXXXXXXXXXXXXXXXXXXXXXXXXXXXXXXXXXXXXXXXX---XXXXXXXXXX---XXXXXXXXXXXXXXXXXXXXXXXXXXXXXXXXXXXXXXX------XXXXXXXXXXXXXXXXXXXXXXXXXXXXXXXXXXXXX----XXXXXXXXXXX-XXXXXXXXXXXXXXXXXXXXXXXXXXXXXXXXXXXXXXXXXXXXXXXXXXXXXXXXXXXTTXXXXXX---XXXXXXXXXXXXXXXXXXXXXXXXXXXXXXXXXXXXXXXXXXXX
