------r-------r------------rXX-----------------------------------------r----------r------------------r-----------r-------------------------------------r----r-----------------------r-rXXXX---------------rXXXXXX--X--r---------------------r-------------K-----T--------------r---#--#------------r------r---------------------------------r---r--------XXXXXX------------------------------------------##--#--
---------------------------------------------------------------##----r------------rr-----------------------------------------------------r---r-------------------------------------------------------------XXXXXX--XXXXXX-----------r-r--grg------------r-------Tk----------------##--#-----2C-----------r---r-r------------r----------------------------XXXXX-----------r---------------##-------------###--##-
------r-------------------------------------------------------###----r---------------r-----------------------------r----r------------------r-----------rr------------r-----------r---------r-----------r------------XXXXXXXX-X-XXXXXXXXXXXXXX-r-----------------Tr--rr-rr---r--#g###--#--------r------------r-------------------------------------------------------------------r--------#rrrrr----r---####--###
-------------------------------------------------------------####-----SS--r--------------------------r--------------------r---------r-----r------------r-r-----r-----r-r-------------r-------------r---------------------XXX-X-XXXXXXXXXXXXXXrXXXX---XXXXXXXXXXXXXXXXXXXXXXXr-######-------r---------------S------------------------r-------r----------------------------------r---r---XXXXXXXXXXXXX--#####--###
----------------------------------------------------r-S-----#####----------------------------------------------------------------------------------r-r---------r-S----S------r-------------r-----------r--------------------------------------XXXX---XXXXXXXXXXXXXXXXXXXXXXX-XXX####-------r--------------------------------------o--------------------2-r--------------------XXXXXXXX-XXXXXXXXXXXXX-XXXXXX--XXX
------------------------------rr-----------r----------------#####-------------------rT---TT-------------------TT--------------------------------------------------------S---------r----------------------------------r-------------------------------------------------------XXXXXXXXXXXXXXXXX----------r---------------------------------------------------------------------XXXXXXXX--------------rXXXXXX--XXX
---------------------rr--------------r------Sr-SSS-------y#-#####-------------------TT---TT-------------------TT---------------------------------------------------------SSS-------------------------------r-------------r------------r----------r--------------------r---------XXXXXXXXXXXXXXX--XXX---------------K-------------o----------------------------r--------2-r--------------------------r-----------
-----r-r-------------r---------------------r----------#####-#####------------------rTT---TT-----B-------------TTr------------------------------------------------------------------------------------------------------------r-----------------------r---------r---r--------------------------X--XXX---r---r--------------------------------------------2-----r-------------------------------------------------
------------------------------r-----------------------X####-#####---r---------------TT---TT-XXXXb-r---k-------TT---r----------------------r-----------------TT---r----r--------------------------------------------r--------------------------------------------------------r-----------------------------r--rrr-------#----r-----------B--------##---------------------rr--------------------------------------
--------r---------------------------------------------XXXX-XXXXXXXXXXX-------r-r--gXXXXXXXXXXXXXXXXXXXXXXXXXXXXXX--------------------------------------r----TT--------T-------------------------------------------------2-------------------------r---r----------------------------------------r---------XXXXXXXXXXX--XXXXXXX-----------b-------g##---------------------2-------------r-------------------------
----------#@@@@-----------------r------r-------T-----rXXXX-XXXXXXXXXXX---XXXXXXXXXXXXXXXXXXX----XXXXXXXXXXXXXXXXX----------------r--------------rr--k--r----TT--------Tr--------------------------------------------@---------r-------------r----------r-----r------r----------------------------r-------XXXXXXXXXXX--XXXXXXX-----------B-rr----####------------------------r-----------------------------------
----------r------------------------------------S-----r-------------------XXXXXXXXXX------r-------------------------------X--rr-XXXXXX-----XX-X-XXXXXXXXX----TT---XXXX-Xg------------------------------#------------------r-----------------------------------------r------------------------------------------------------------r-XXXXXXXXXXXg-#####-rr----r--------------------r---------------2---------------
-----------------------------------------------------r--------------------------------------r--------------------------XXrX-XX-XXXXXX--XXXXX-X-XXXXXXXXX---XXXXX-XXXX-XX----------------------B-------#---------##-------2-------------------------------------------------------------------r------r-----------------------------XXXXXXXXXXXXXXXXXXXXXXX---SSS----r--------------------------------------------
--M-r-r-r------------r---ggg---r----r---r--ggg----gg-r------------------------------------------r----------------------XX-X-XX-------r-XXX-----------------XXXXX-------X------rtrrr----TT-----b-------#r-------###---#-----------------------------------------------------------------r-----!------r----------------------------------------XXXXXXXXXXXX#-K--K----r--r------r--r-------------------------------
XXXXXXXXXXXXXXXX----XXXXXXXX--rXXXXXXXXXXXXXXX-XXXXXXX-------------------------------------------------------------------r---------------------------------------------------XXXXXXXXXXTT---XXXXXXXX--XXXXX---####--#-----Sr--r----------------------------------g---------------------#---r---------S--------------r------------------------------------rr-----XXXXXXXXX--------S------------------------------
XXXXXXXXXXXXXXXX----XXXXXXXX-XXXXXXXXXXXXXXXXX-XXXXXXX------------------------------------------------------------------------rr--------------------------------------r------XXXXXXXXXXXXXXXXXXXXXXX--XXXXXr-#####--r--------r-----------------------------------T---------------------#------r---------------------------------------------r------------------XXXXXXXXXXXr-------------------------------------
