--------------------------------------------------------------------------------------
--------------------------------------------------------------------------------------
--------------------------------------------------------------------------------------
-----------------------------------------------------------------------oo-------------
--------------------------------------------------------------------------------------
--------------------------------------------oo---%%%%--------------------%%%%---------
---------------SSS-----------------SSS------SS----||--------------SSS-----||----------
--------------------------------------------------||------SSS-oo----------||----------
--------------------------------------------------||----------------------||----------
----%%%%%%--------------%%%%%%-----------------SS-||%%%%%-----SS----------||----------
-----||||----------------||||---------------------||-|||------------------||----------
-----||||----------------||||---------------------||-|||------------------||---------F
--M--||||----------------||||---------------------||-|||------------------||---------X
%%%%-||||-%%%%%%----%%%%-||||-%%%%%%----%%%%-----%%%%|||------------------||-XXXXXXXXX
-||--||||--||||------||--||||--||||------||-------||-|||------------------||-XXXXXXXXX
-||-----------------------------------------------------------------------------------
