-------------------------------------------------------------------------------------------------------------------------------------
-------------------------------------------------------------------------------------------------------------------------------------
-------------------------------------------------------------------------------------------------------------------------------------
-------------------------------------------------------------------------------------------------------------------------------------
-------------------------------------------------------------------------------------------------------------------------------------
-------------------------------------------------------------------------------------------------------------------------------------
---------------------LSSS---------------------!!!!!-----------USSS--------------------------------------------------------##---------
--------------------------------------------------------------------------------------------------------------------------##---------
-----------------g------------------------------------------------------------------------------------------------------#-##---------
-----------------#------------------------------k-----------------------------------------------------------------------#-##---------
--------SUS-----##---2-----#-----------TT-----@!!!!----------S-----TT-------------------------------------------------#-#-##---------
---------------###---------#-----------TT--------------------------TT-------------------------------TT----------------#-#-##---------
--------------####---------##----------TT--------------------------TT-------------------------------TT---------TT---#-#-#-##--------F
--M----------#####----kk---##---gg-----TT------------gg----k-ggg---TT-----k------------k------kkk---TT---------TT---#-#-#-##--------#
XXXXXXXXXXXXXXXXXXXXXXXXXXXXXXXXXXXXXXXXXXXXXXXXXXXXXXXXXXXXXXXXXXXXXXXXXXXX---XXXXXXXXXXXXXXXXXXXXXXXXXXXXXXXXXXX-X-X-X-XXXXXXXXXXXX
XXXXXXXXXXXXXXXXXXXXXXXXXXXXXXXXXXXXXXXXXXXXXXXXXXXXXXXXXXXXXXXXXXXXXXXXXXXX---XXXXXXXXXXXXXXXXXXXXXXXXXXXXXXXXXXX-X-X-X-XXXXXXXXXXXX
