--------------------------------------------------------------------------------------------------------------------------
--------------------------------------------------------------------------------------------------------------------------
--------------------------------------------------------------------------------------------------------------------------
--------------------------------------------------------------------------------------------------------------------------
---------------------------------------------------------------------------------------------------------------k----------
---------------------------------------------g-----------------!!!!-----------------SSSSS----------------------##---------
-------------------------------------------SSSSSSSS-----------------------------------------------------------###---------
-----------------k---------------------k--------------------------------------------------------------------k####---------
-----------------------------------------------------------------r-----------k------rK----------------------#####---------
--------------k------------o----------------------------------!!SS!!!---------------SSSSS------------------######---------
-----SSS------TT-------------------------@S--------------------------------------------K---#--------k-----#######---------
--------------TT----TT-k------------------------------------------------------TT-k---------#----TT-------########--------F
--------------TT----TT----------------------------------------k-------------k-kT-----------#----BTkr--r-#########--------#
--M------------T---kkT----k-k-rk------k---------------XXXXXXXXXX--XXXXXXXXXXXXXXXXXXXXXXXXXXXXXXXXXXXXXXXXXXXXXXXXXXXXXXXX
XXXXXXXXXXXXXXXXXXXXXXXXXXXXXXXX--XXXXXXXXXXXXXXXk-----XXXXXXXXX--XXXXXXXXXXXXXXXXXXXXXXXXXXXXXXXXXXXXXXXXXXXXXXXXXXXXXXXX
XXXXXXXXXXXXXX-XXXXXXXXXXXXXXXXX--XXXXXXXXXXXXXXX----XX-------------------------------------------------------------------
