--------------------------------------------------------------------------------------------------------------------------------------------------------------------
--------------------------------------------------------------------------------------------------------------------------------------------------------------------
--------------------------------------------------------------------------------------------------------------------------------------------------------------------
--------------------------------------------------------------------------------------------------------------------------------------------------------------------
--------------------------------------------------------------------------------------------------------------------------------------------------------------------
--------------------------------------------------------------------------------------------------------------------------------------------------------------------
------------------------------------------------------------------1---------------------------------------------------------------------------------------#---------
-------------------------------------------------------------------------------oooo----------oooo-------------ooo-----------------------------------------#---------
---------------------------------------------------------------------------------------------------------------------------------------------------------T#---------
------------------------------------------------------------------------------------------------------------------------------SSUSSSSS-------------------T#---------
-------------------------------------ooo------------------------!!!!----------------------TT--------------TT---------------------------------------------##---------
-------K---------------------------------------------------------------------#------------TT--------------TT------------K-------------------------------#-----------
-----------------------------------------------------------------------------#------------TT--------------TT--------------------------------------------#----------F
--M-----------ggg---------y-y-------------------y-y--------------yy----------#---------y--TT---y------y---TT--------y---------------------------------kk#----------#
XXXXXXXXXXXXXXXXXXXXXXXXXXXXXXXX--XXXXXXXXXXXXXXXXXXXX---XXXXXXXXXXXXXXXXXXXXXXXXXXXXXXXXXXXXXXXXXXXXXXXXXXXXXXXXXXXXXX--XXXXXXXXXXXXXXXXXX-X-X-XXXXXXXXXXXXXXXXXXXX
XXXXXXXXXXXXXXXXXXXXXXXXXXXXXXXX--XXXXXXXXXXXXXXXXXXXX---XXXXXXXXXXXXXXXXXXXXXXXXXXXXXXXXXXXXXXXXXXXXXXXXXXXXXXXXXXXXXX--XXXXXXXXXXXXXXXXXX-X-X-XXXXXXXXXXXXXXXXXXXX
