--------------------------------------------------------------------------------------------------
--------------------------------------------------------------------------------------------------
--------------------------------------------------------------------------------------------------
--------------------------------------------------------------------------------------------------
--------------------------------------------------------------------------------------------------
---------------------------------------------------------------------------------------y----------
------------------SCS------------------------------------------------------------------##---------
---------------------------TT--------------------------------------------------------y###---------
---------------------------TT--------------------------------------------------------####---------
---------------------------XX-------------------------------------------------------#####---------
-----SSS------TT---2---TT----------------------------------------------------------######---C-----
--------------TT-------TT-------------K----------------------#--------------------#######---------
--------------TT-------TT-----TTTT-------K-------------------#-------------------########--------F
--M-----------TT----k--TT-----TTTT-----------#---------------#----y--y----------#########--------#
XXXXXXXXXXXXXXXXXXXXXXXXXXXXXXXXXXXXXXXXXXXXXX---XXX--XXXXXXXX--XXXXXXXXXXXXXXXXXXXXXXXXXXXXXXXXXX
XXXXXXXXXXXXXXXXXXXXXXXXXXXXXXXXXXXXXXXXXXXXXX---XXX--XXXXXXXX--XXXXXXXXXXXXXXXXXXXXXXXXXXXXXXXXXX
