--------------------------------------------------------------------------------------------------------------------------------------------------------------------------------------
--------------------------------------------------------------------------------------------------------------------------------------------------------------------------------------
--------------------------------------------------------------------------------------------------------------------------------------------------------------------------------------
--------------------------------------------------------------------------------------------------------------------------------------------------------------------------------------
--------------------------------------------------------------------------------------------------------------------------------------------------------------------------------------
------------------------------------------------------------------------------------------------------------------------------------------------------------oo------------------------
---------------------LSSS------------------------------------------------------------!-!-----------------------------------------------------------------------------------##---------
--------------------------------------------------------------------------------------------------------------------------------------------------------------------------###---------
-----------------g--------------------@----------------------------------------------------------------------------------------------------------------------------------####---------
-----------------#--------------------------------------------ooo--------------------------------------------------------------1--------o--------o----------------------#####---------
--------SUS-----##---2-----#-----------------------ooo-------------------------------!-!-----------------------------------TT----------------TT--------TT--------------######---------
---------------###---------#------------------------------------------------------------------------------------K----------TT----TT----------TT--------TT-------------#######---------
--------------####---------##---------#---------------------------------------------------------------------------B--------TT----TT----------TT--------TT---------tt-########--------F
--M----------####-----kk---##---g-T---#-------k-kkk----kk------------------y-----------y-y------------------------b-ggg-----T---kTT----------TT--------TT---Tgg----t-########--------#
XXXXXXXXXXXXXXXXXXXXXXXXXXXXXXXXXXX---X--XXXXXXXXXXXXXXXXXXXXXXXXXXXXXXXXXXXXXXXXXXXXXXXXXXXXXXXXXX----XXXXXXXXXXXXXXXXXXXXXXXXXXXXXXXXXXXXXXXXXXXXXXXXXXXXXXXXXXXXXXXXXXXXXXXXXXXXXXX
XXXXXXXXXXXXXXXXXXXXXXXXXXXXXXXXXXX---X--XXXXXXXXXXXXXXXXXXXXXXXXXXXXXXXXXXXXXXXXXXXXXXXXXXXXXXXXXXX--XXXXXXXXXXXXXXXXXXXXXXXXXXXXXXXXXXXXXXXXXXXXXXXXXXXXXXXXXXXXXXXXXXXXXXXXXXXXXXXX
