----------------------------------------------------------------------------------------------------------------------------------------------------------------------------------------------------------
----------------------------------------------------------------------------------------------------------------------------------------------------------------------------------------------------------
----------------------------------------------------------------------------------------------------------------------------------------------------------------------------------------------------------
----------------------------------------------------------------------------------------------------------------------------------------------------------------------------------------------------------
----------------------------------------------------------------------------------------------------------------------------------------------------------------------------------------------------------
----------------------------------------------------------------------------------------------------------------------------------------------------------------------------------------------------------
---------------------LSSS---------------------!!!!!-----------USSS--------SSCSS------SSSS-----------------------------USSS-------------------------------------------!------------------------###---------
----------------------------------------------------------------------------------------------------------------------------------------------------------------------------------------------###---------
-----------------g-------------------------------------------------------------------------------------------------------------------------------------------------------------------------y--###---------
-----------------#------------------------------k-----------------------------------------------g--------------------------TT------------------oo------------------------------------------#--###---------
--------SUS-----##---2-----#-----------TT-----@!!!!----------S-----TT---!!!!--!!!---------------TT-----------------TT------TT-----------------o--o-------------------!--------------------##--###---------
---------------###---------#-----------TT--------------------------TT---------------------------TT----------g------TT--tt--TT-----------------------------------------------------------y###--###---------
--------------####---------##----------TT--------------------------TT---------------------------TT----------TT-----TT--tt--TT-----------------------------------------------------------####--###--------F
--M----------#####----kk---##---gg-----TT------------gg----k-ggg---TT------------ggg------------TT----------TT--g--TT--tt--TT-----k------------------------y-----------y---------------#####--###--------#
XXXXXXXXXXXXXXXXXXXXXXXXXXXXXXXXXXXXXXXXXXXXXXXXXXXXXXXXXXXXXXXXXXXXXXXXXXXXXXXXXXXXX----XXXXXXXXXX---XXXXXXXXXXXXXXXXXXXXXXXXXXXXXX---XXXXXXXXXXXXXXXXXXXXXXXXXXXXXXXXXXXXXXXXXX----XXXXXXX--XXXXXXXXXXXX
XXXXXXXXXXXXXXXXXXXXXXXXXXXXXXXXXXXXXXXXXXXXXXXXXXXXXXXXXXXXXXXXXXXXXXXXXXXXXXXXXXXXX----XXXXXXXXXX---XXXXXXXXXXXXXXXXXXXXXXXXXXXXXX---XXXXXXXXXXXXXXXXXXXXXXXXXXXXXXXXXXXXXXXXXX----XXXXXXX--XXXXXXXXXXXX
