--------------------------------------------------------------------------------
--------------------------------------------------------------------------------
--------------------------------------------------------------------------------
--------------------------------------------------------------------------------
--------------------------------------------------------------------------------
--------------------------------------------------------------------------------
-----------------------------US-------------------------------------------------
---------------------------------------------------------------------##---------
------------------------------------------------------------------K-###---------
--------------------------------------------------------------------###---------
---------!!-----------------####--SSC------------------ooo--------#-###---------
-----------------------y-#####-----------------------------------##-###---------
--------------------y-######-----------------------------------#-##-###--------F
--M----------------#######------------------y-y---------------##-##-###--------#
XXXXXXXXXXXXX--XXXXXXXXX------XX--XXXXXXXXXXXXXXXX--XXXXXXXXXXXX-XX-XXXXXXXXXXXX
XXXXXXXXXXXXX--XXXXXXXXX------XX--XXXXXXXXXXXXXXXX--XXXXXXXXXXXX-XX-XXXXXXXXXXXX
