--------------------------------------------------------------------------------------------------------------------------------------------------------------------------------
--------------------------------------------------------------------------------------------------------------------------------------------------------------------------------
--------------------------------------------------------------------------------------------------------------------------------------------------------------------------------
--------------------------------------------------------------------------------------------------------------------------------------------------------------------------------
--------------------------------------------------------------------------------------------------------------------------------------------------------------------------------
------------------------------------------------------------------------------------------------------------------------------k---------------------------------------k---------
---------------------LSSS---------------------!!!!!-----------------------------------SS!SSS@SSS--------SSC------------------S!S--S!S--------------------------------##---------
--------------------------------------------------------------------------------------------------------------------------------------------------------------------###---------
-----------------g-------------------------------------------------------------------------------------------------g#---------------------------------#-----------k####---------
-----------------#------------------------------k---------------1--------o----k---------K---------------SSS-------g##---------------------------k-----#-----------#####---------
--------SUS-----##---2-----#-----------TT-----@!!!!---------TT----------------TT------SSSSSSSSSSS-----------------###--------S!S--S@S--------SCSSS----#----------######---------
---------------###---------#-----------TT-------------------TT----TT----------TT---------------------------------####--------------------------K-----##---------#######---------
--------------####---------##----------TT-------------------TT----TT----------TT--------------------------------#####--------------------------------##--------########--------F
--M----------#####----kk---##---gg-----TT------------ggg----TT---kTT----------TT--------------K----------------######------k------ggg--------K---K---##-------#########--------#
XXXXXXXXXXXXXXXXXXXXXXXXXXXXXXXXXXXXXXXXXXXXXXXXXXXXXXXXXXXXXXXXXXXXXXXXXXXXXXXXXXXXXXXXXXXXXXXXXXXXXXX----XXXXXXXXXX--XXXXXXXXXXXXXXXXXXXXXXXXXXXXXXXX---XXXXXXXXXXXXXXXXXXXXXX
XXXXXXXXXXXXXXXXXXXXXXXXXXXXXXXXXXXXXXXXXXXXXXXXXXXXXXXXXXXXXXXXXXXXXXXXXXXXXXXXXXXXXXXXXXXXXXXXXXXXXXX----XXXXXXXXXX--XXXXXXXXXXXXXXXXXXXXXXXXXXXXXXXX---XXXXXXXXXXXXXXXXXXXXXX
