------------------------------------------------------------------------------------------------------------------------------------------------------
------------------------------------------------------------------------------------------------------------------------------------------------------
------S-----------------------------------------------------------------------------------------------------------------------------------------------
------------------------------------------------------------------------------------------------------------------------------------------------------
------------------------------------------------------------------------------------------------------------------------------------------------------
-------------------------------------------------------------------------!-----S-SSS------------------------------------------------------------------
-------S--------------------------------------------------------------------------------------------------------------------------S-------------------
------------------------------------------------------------------------------------------------------------------------------------------------------
------------------------------------------------------------------------------------------------------------------------------------------------------
--------------------------t-----------------------!t----tt---------S!--!SC-!--S-----------------------------------------------------------------------
------S---------S!@--t----t------------------------tt---tt---------------------------------------------!S!S!!-------------S!----SS--------!--S!-------
---------------------tt---t------------------------tt---tt------------------------------------t-------------------------------------------------------
--------------------ttt---t------g------g---M------tt---tt-------------k--------g---gg#-t-----tt--------------tt----tt-------tt-----------------ttttF-
--------------------ttt---XXXXXXXXXXXXXXXXXXXXXXXXXXXXXXXXXXXXXXXXXXXXXXXXXXXXXXXXXXXXXMt-----tt-------------#tt----tt-------tt-----g-g---------tttt#-
XXXXXXXXXXXXXXXXXXXXXXXXXXXXXXXXXXXXXXXXXXXXXXXXXXXXXXXXXXXXXXXXXXXXXXXXXXXXXXXXXXXXXXXXXXXXXXXXXXXXXXXXXXXXXXXXXXXXXXXXXXXXXXXXXXXXXXXXXXXXXXXXXXXXXX
XXXXXXXXXXXXXXXXXXXXXXXXXX-------------------------------------------------------------XXXXXXXXXXXXXXXXXXXXXXXXXXXXXXXXXXXXXXXXXXXXXXXXXXXXXXXXXXXXXXX
