-------X----X---|-------------X-------X-------r-------X-----------XX----X--X#-k--------X-S---------XXXX#-----#-tX----UXX-------G--------X-------------
-------X--X--X-----X----X---L---------T-X-%X--X---X-X-----X-X---------X---X-X---Ro------1-X-X------X-X------%--------Y-#---------X-1--------X-X-X-S---
----g#-----X--X-X-X---T---M#---F------X--#@#--------X-------------------X----X-X-X-----X-#---X-XXX-XX---X-------------C------------X----X--X------XX--
--------X--------------XX------------------X----------------------T-X-------------%----XX--------X--X------T----------------Y--X*X--S--------------%--
----------X-XX-------#----1------!-------#-------S-------X--Y-------X------@-XX-----------X---X-X---X---X--------X--------------------|----X-------@-S
--------------X-X---------%X--XX-----X------------X--------------XR-XX----*--X---X-------X---X--XX---------------%Xt--*X-X-X---------X--X---------t---
------------X--X---XX-k-------X-X-X----X----------------------TT-R--------X-X---XX----oX-----XX%----X-X-------X-XG----X--------T----X#X---%--Mk-M----X
----------X--Xt-----------XXCS------2t---------X---L----XX-------------#------t--------#M---#-#Xk--%--#---------XX------------XX--------X--------XXX--
-------X-----T--X----------g-X@----X--X------------X----X-----X#X-----------@----D--------------------X--------------X-----------R-------t-XXX---X----
-------X--F------------X|X#----*X---L-----------------X---X-----------X--kX-X-X-X--------X--@----SX--r---XL-----X-----------X-------X-X--------X-X----
--------X-g---X---X-------X---%--X----XX-XG----------X--G----X-X-----X-XX-------------------T---X------L#-X----------#----X--#-----------K--G---------
----%-----X----X----------------------------SX-X-----@-yX-----X----X-------------K--------X#-X-----------X--X------X---------2-X-----------X--X----D--
-------X-X-----------------X------K----X---Y-@---#------------XX------#---X--Y----#---D-------------------------L--------XX---X----X------------------
-----------#-X----------------------------------S----FY----X----------X-X-X----X%-----------------X-X-------X-------gX--X--X-------------X-------o-X--
XXXX---X--C-X---X----------------------X---------@-----------X---------X-#----X-XX-------------X---XX-----X#-X----------------X---X----@----------X-|-
XXXX----------o-XX----K--X-X-X-K--X------X---X--XX-X--X-------------------o----X-------S-------X#----------XX----#---X---X--X---X--X----tX----X---X---
