----------------S-S------------X---X-gT----X--X--X@---X-----K-X--X--X----------X-tX-------------g----XS------------X--------------X-X--t--r-------gXg-
--------------------X-----X-r--g---X--X----------------X-X---------------------X---------X-X-----2---X---XX------X-----X-!------------------Xt--------
----X-X-------------------------------X-#------X----g-----X----------XX----X-------Xt---------------XX--M*-----------t------KXX------X-------t-X--XX-X
-------X---------X-----S--X-----X-----------X-X-g-------X------Xr-S--X-X-X-X--T------------X1---XX-----X--------X-------T-----X--------#---X-X#-----X-
-------------XX--X#-X--X------------S--------C-SXX--------X----X----------------XF-------------X------X-XX----X------#---------------------X--#X-----X
---------------L---------------X------X--------XX--------------XX------X---!-X------X--#-X------XXX-X---XX--X---XT---SR-X---------X-----S-----------X-
------X----------------X--X------2-X------!---T-X----------------XX-----XX---X------X-X----X-*------1---!--S--X----XS#-----T-------XX----------X------
-----#------------X-2----X----------R-X---XX----#-------X------X---------X---------------X---g#------X-X-X--X-------------2----------FX----X--!------X
-------X-k----X---S-X--X--------------#---------------X-----------------R-----------X----##X-----X--X-----X-------t----#----2--X----S-X----------X----
-----------X-#SXX----------X-----#--------X---LX--X#------L-----X--------------------X-------X-S-------------1--#T-X---#---X-X-X-X----X-------#X#-----
---------------------XXXX--X------C--X--------------------X---X----------U-#------XX-----X----------XX-------o-X----#--------------------XX----Y----#-
-----------X---g----X-------X---------X-----------------X-----------X-X---XS--------------X-----X-----------X----@------------X--M-XX-----C!-X------X-
----X------------X#-X-------X----------SX----X-U-------X-----X---X-----------------#X------------X---gX----------Y--------X------#--------X-----------
-------X--------#-----X----------X-------------X-------X-----X------1XM------DX-t-----X---X---------S-XX----X-----------X--X---X--X-----#-------------
XXXX--------X--X----X------X---------X---X---XX----X-X-------!-----------------------X------X------------#-X-------X------X---X---X--@---------------2
XXXX----X-----#-XX-----XX-1---T--S-----T-----X---S---------X----------X-----*-XX---X---X--X----#X--X--#-----------------X--------X-----------X--t----X
