--------------#------#---------------T-------XXXXX-------SS-----------------------S-T-------g--------------------------T----#----ST--------------ST---
--------------#------#---------Tg----T-------XXXXX----------------X-------------S---T-T----TS----T-------#----------g--S-r--#----S--------T--T---ST---
--------------#kk----#----g----TT----T-SSS------------------------X--T--------------T-T----T#g---T----T--#----SSXXXXXXXXXXXXXXXXXXXXXXXXXXXXXXXXXXX---
S----SS-SSSSSXXXXXXXXXXXXXXXXXXXXXXXXX-------------------------------T-------S-----SXXXXXXXXXXXXXXXXXXXXXXXXX---XXXXXXXXXXXXXXXXXXXXXXXXXXXXXXXXXXX---
S-------------XXXXXXXXXXXXXXXXXXXXXXXX--------------S----------------T----S------S--XXXXXXXXXXXXXXXXXXXXXXXXX-----------------------------------------
S-------------------------------------------SSSSSS----------------SXXX-S----------S-------------------------------------------------------------------
S-------------------------------------------S----------------------XXX--------------------------------------------------------------------------------
S------------------------------------------S------------------------------------SS-----------------------------SSSSSS-SSSSSSSSSSSSSSSSSSSSSSSSS-SSSS--
S-------------SSSSSSSSSSSSSSSSSSSSSSSSSS--------o-----S----------T-------------------SSSSSSSSSSSSSSSSSSSSSSSSS-----------S-----------------S----------
S---L-----------------------SS---S--------------------S----------S--------SSS--------------------------------------------S-----------------S----------
S------------#--------------SS------------------S---S--------XXXXXXSSS-S------------------------------------------------------o------------S----------
S------------#-----o--------S---------------S---S------------XXXXXXS--------------S-----o------------o-------------------------------------S----------
S---------T--#--------------S--------------------##----------------S-------------S--------------------------------------------S-----------SS---------S
S-------F-#T-#-----S--------S-----------S--------##-----S-------------S-------SS--------S------------S--------S----------o------------g---SS----------
XXXXXXXXXXXXXXS------------CSL----------------#--##--T-----------------------S----------S-----S-----SS------------@------S------------T----S-!--------
XXXXXXXXXXXXXX-#------------SS--------T-----S-#--##--S-------SSSSSS------S----------ST--S-------------!----S----#------------#----S---------------ST--
