--------------------X--#--!-------X-X-X-----------#----------X----------------#----t-----X--X-X--X-#---@X-----X------tX------X--X----------------tX-XX
-------------------------#----X--gS--X-#-X-#-----X----#-X-------------------X----------X--------#-----X-#----------#-tS-----X--#X-------------------X-
---------X##-----------#-X-X----XX-X----S------------S------------XX-----X--tX--X-------------X-----X-----#-----t-#------X-------X--------------------
-----#----X-----------X-X--------#----------X-X----X-S------SX----------X-#-X-----X------------------------#----------g-#----X----------#-----t---X-X-
-------X------X-----X--S----S----#----------------#--------------------------XXtX----XX------X--#---XX----t-SX-----X-------X---X--!X------g-g----X----
-----XX-----------X---X------#---XX--#------------X-X-S-----------1X----X---------------------------------#-------XX-X--XX-----#----X---XX------------
------#-!---X-X--------------X---------------------------X-L-S-----X--------Xt-----!#----X---------!-X--X---#-Xt--X-X---X--S---------X--------X-X-X-XX
----X-----t-----------------------g--X------X-------#---------------X---X-------------X------X------------------X--X---------K---X---------X--X-------
-----------X--------------S--X#---X---------X--------#X-S-------#-#--------------t---#--t-----X--#----------------------X----t----------X---------#---
----X#--X-#----XX-X--X-------SXX---XX---Y--X-----------SX-----------X--!X----X-X-t-----X--X-------------------------#----X--------##---X---------X----
--------S-----------X-X---XX---X-X----------------!-------#---X--#X-X--X---------X------X---#-----X---X--#-#tX--X--#----!X-------#-----------##XX----X
----------X----X-----#-------X---X----------X-----------X--#------------------------------X-----X----------X------S----X-t-------#---X--X-----S-------
-------------------X--#--S-----X----X---S---S--------X--X---X-XSX-X-Xg---------t--X----X-------#---------#------X-------------X!g---X--#------tX------
---------------------Xt----#----#-M-X-------X----------X--------------t---------X------#X-X-----------#-!---------------X---X--X---X---S-t-X---XX-X-X-
XXXX-------------X-X--------X----#----X------------X---t---X--X-----#--X---------X-------X-------XX-------g--X---X----X---X-----#-X-X--------X--X-----
XXXX--X---X-----X---X--X----X-----------#-------X------XX-----t----------X--XX---X-----SX--#-X--X---X-X-X------t--------------X----X----X-X------#----
