---------------------------XXXXXXXXXXXXXXXXXXXXX--T------------t#--X-----------------------------S-------S--------------------------------------------
-------------------------------XXXXXXXXXXXXXXXXXXXXXXX----##----Tt----------------S--------------------------------------!----------------------------
-----------------------------------------g-----X---XX-XXX-XXX--#--Tg--kT---#-----------------------------------------S----S--@-------!----------------
------------------C--------------------------------------X-XXXXXXXX-XXXX---T-----TT--#--------!g--S---X-----------------------------------------------
-------------------------------------------------------------XXXXXXX-XXXXXXX--------------------1#---#T-------------------S------------S--------------
--------------------------------------------------------------X---------XXXXXXXXXXXX#XXXX-------t----X-------------T-----------------X---#--------!-S-
--------------------------------------------#-----------------------------------XXX-XXXXXXXXXXXXX-g-----X-----------T---------------S#-#---------k----
---------------------L--------------------------------------------------------------------X-XXXXXXXXX-XXXXX--#----K----tr-t-T--#--2#---#---------#--##
-------------------------------S--------S------------------------------------------------------#-X-XXXXXX--XXXXXXXXXXXXXgX-T#--------t--------T-------
-----#----#-#---S-----------------------!--!---------X--------------------------------------------------------X-XXXXXXXXXXXXXX-----#-tX-XXX---t-------
--------T--T#----#----------------------------------------------------------------------------------------------------------XXXX-XXXXXXXXXXXXXXXXXXXXX
----t-#---------#----------------------------S------------------------S-------------------------------------------------------XXXXXXX---------XXXXXXXX
----g--#t--##--#X-----K-----------------X##---#----#-----------------------------S--------------------------------------------------------------------
----XXXXXXXXk-XXXX-X-T------------------##---!----C----------#----@------------SC---------------------------------------------------------------------
XXXX-XXXXXXXXXXXXXXXXXXXXX-------kTk-----#----------------t-#-----------------------------------------------------------------------------------------
XXXX--------X-------XXX--XXXXX--X----##-----##--#k----------#T-#-1------------------#-----------------------------------------------------------------
