--------XXXXXX--XXXXXXXX-XX-XXXX-XXXXXXXXXXXXXXXX-XX-------------XX--T--g#-----k-------g----#-------------#-----S-----#----M----------------!--------t
-------------------------------------XXX-XXXX-XXXXXXXXXXXXXX-XXXXXXXXXXXXX--X--X--XXXXXXXXXX--XXXX---t#----T---#-------#-------X------XX-XXXXXXXXXXXgX
---------------------------------------------------XXXXXXXXXX-XXXXXXXXXXX-XXXXX--XXXXXXXXXXXXXXXX-XXXXXX-XXXXXXXXXXXXXX-XXXXXXXXXXXXXXXXXXXXXXXXXXXXXX
------------------------------------X-------------------------------X----------------------------X-XXXXXXXXXX-XXXXXXXXXXXXXXXXX-XXXXXXX---------X-----
---------------------------------!------------------------------------------------------------------X-------------------------------------------------
------------------------------------------------------------------------------------------------------------------------------------------------------
----CS-------!----------------------S-----------------------------------------------------------------------------------------------------------------
----------------------!------U---------------S--------------------------------------------------------------------------------------------------------
--------------------------C------S--------S-----------------------------------------------------------------------------------------------------------
----------------S------------------------------X--------SU------------S----------S--------------------------------------------------------------------
-------------------------------!T---#--------------------------------------------------------------S---S--------------!-----------------------------S-
---------------------------------T------------------------------#---------!-----------S-----------------------------------S---------------------------
---------------------T----------TT-#----------------#-------------------------------------------S-----------C------------------S----------------------
----X-X--------!------!---------X--g-----------U------------g------#-----------------------L-S#------------------------S------------------------------
XXXXXXXX-g-!--------#T-g----#--X#XXF------------------------------T@#T--X----F-----------t---#--------------#---------------!-----------#-------------
XXXXX-XX-XXXXXX-XXXXXXXXXXXXXXXXXXXXXX-g---------------------------#--T------t---------------------S-------k----------------K------------------g----#-
