----X-yX------X-T------------X----------X----X------------X--------X------X--2---------X--------X----X------------X--X-XX-X----XXXX-----X-----XXX-----
-----------------------------X-----------#---------X---g-------G----L-----X-----X---------X------X---@---XX--------R-------1Y------%--XX------S---X--X
-------X-Y-----X------T----g-------X-------------X---|XX!-------XX-----------X-----#X-XXX---r-----X---------------X-!X-----X--X--------XX-------------
----Y------X-------K-XX----X----------------------------XFX-X----XX----X-X-----o---XF--X-X----X--X|--------XX-X--X--X-----------------g----X-Y-------t
-------X-----X--------XX----------X------------------X----XX--X----X-X-------|--YkX--------------1------X--X--X---SX-----X-----X------Y---------------
---------------X--o----X---C--X|---------t----------%--|*-----X----R-------------X------------X----1----------%X-----X---X-----------%-----X----X----#
------------------------------------y-----------X---X---------X--%--X-X-------------#T--------X-T----X@---X--#------X-X--------------K1X-X--X---------
----------X-----K---------X-C-----XX----------------X-------X------X-----X-------|---X----XgX--X------XD-X------X-*---X--X---X-------MX-------X---X--X
----X-----------------X------X------X-------------------|------X-----t-----*X-X-S----------X---|-----#X---------------X-X-g--t-SX----------XLX--X-#---
---------X@X--X-----U---------g---XX---------------------@--X---t-----X-----X------------X--X--o--X%-X--------RX----X-----X---XXX---S---------X------X
--------X---S#-----X-----@---X------1--1X-----X--------------%-------Xo------|X--X-X---X-X-----X---X-R--X-------X-------XX--X----LX---X---------------
------------rX#-X-----------X-------#----t-X----XGXXX-----X-*-----t--G-S-----|--X----------------T------X-X-Xg----X-------X-----X---------X----X------
---------M-----S----------%-------------S--X---------------R---#--X---X----XL-#----X----------------#-------t-----X--------------X-----X---------X----
----X--X-------------*XX------X--X-X--------D--------XXX-X---r--------X-----Xr--X---X----------Y---X------%--M--X-#---------X---XX-----G--X----XM-----
XXXXX-------------X-----X---------XX---X---X-X---------------X--X-T----R-X-Y--#------X-----------X---------------X------X--------------------X--XX----
XXXX--X----------F---X@------------#----XX--------X---G---------R-----X----X--k-----X-X---------X----------X---------------------------------------X--
