------------------S---------X-----------X--X----------------------S---S--X------X--------------S-----------------------X------X-------X-X--------S----
----SS-----#-----X-------X-----------X--S-------U-----------X-----------X----------XS---X---S--S--------X-----------------------#--S---#X-------X-----
------------------S-----X--------#-----#----X-----------#-----------------------#-----X-r---S---XX------------------XXg--------U----------------------
S----------------S----X-------------------X----S-----------#X-------------------------------X----------X----------------------------------------------
S---------X---S----X----S---------------------------S--XX------------#S--------X------#---SS--------X-----------X--------X-----------XS-XX------X-----
S-------S------X-S-U-S-X----------------S----------X-XX-----S----------#----S----X----#-------X-----------X--------------X--------S-----------X-------
S------X---X-------------------------------X---------------S---S------X------S-----------X--#---------S------S--XX---------------------------------X--
S----U--S---------S-----------g!----X--------S--------------------------------S---*--------#----L-XX--X--------------------------S-------------X------
S--------------------S---rS--------------------#--#---------#------------#S----------X-S--XX----------------#-S--S--S-------------------XU------------
S------S-S#----------X-----------------------------SS-S-------X----X--------------------S-----S----#-X---#----------X---------S-----------------------
S---------S--------------------X------------X---S--X------X-----S--XS------------------X-------------XX-S----X---------X--------#--#-----------#------
S------------g-----------S-------S--------------#-------------------#------X----X--------------#---------X--X--XX-SSX----X------------#--------------X
S-------T-----------------X------X----X-X------------------------X---------------S---XXX------------S-------------------X------------X-----X------X---
S-------X--S--------------------------SX----X--X-------------------X---XXX----#-----r----------X-------------X------X-------------#----X-------------X
XXXX--------------------X--S----X----------------#------X--#X---S------------------X---------X--------X------------------X--S#------------------------
XXXX-------------S-#----X---X------------------------------#---X--------------S-------S#-X----S----SX-X------------------------X---------#------------
