-------X-------X--gX---------@--XXX-X--XXXX-X------X-t-------------X---X---X------XXX-XXT-X-----X-X--X----X--X---------#---#g--X---X---X-------X----XX
-----X---X---------XX--X-X----X--S--#-X------X--------CXX---XX-T------X------X--X-#-X------#--XXX#S-X-X-XK-------XX--X---X-------------Xt-XX-----X----
-----------T-S-X---T----XX---SXX-S----S-t-X-X---XX-X-#--t-----t-----#------!----X--X----XX-X----X-X--XX-X-X---T-X#--X-------------------X------X#---T-
-------X----X---X-X------XX-X--XX-X----X---X---X--#-----------------------X-XX---------k-----XX-X-#-XT--T-----X--t-X-XX--T-X--XX--#--X----!----X-----X
----------g-----------T-X-X-----S--------X--#----X--g-X-----------g-X----XXX---XX-X-X---------#-X----#X----X--#---TX-------X--X---------------X--S--#-
----X--S-X-----#X-t---X#--X---X--X-X-----------X---X--------X--------S-XX----T--X-XX-------XS------------XX-X-------------Xg--X-X-X--X---X-----------X
-----XS--#X-------X-XXX-------#----X--X-----#---X-------TXX-#X-X-----X---#-X--X--------T-------------X--X--X-X--------TX---XXX#-------T-------TXX-----
----X-X--X-X-----X-t----X-#-gXXX--XX---X-----S#-X----#---X--X--XX-C-X-X---X---t-#----X#X------X------X------#XS----XXX-X--X-XX----X---g--X----T-X-X--X
-----T----X---------------X----g--T----#-X-------#----------XX---tXXX--------X--XXt-XX--X-X-------!---XXX-XX-----!XX----------X-X--T----X---X-XX--#X-X
-----2X-----X----S----XX-----X-----------X--XX-t---------XX--XT#-----#gXX----#--X-----#---X-----------X----X----XX--g-X----#---X--X--Xg-XXX--X-----X-X
----#--C---------X-------XX-X---X-X-t----X-X----XT----X---X----X-X---#-TX-------S-#------X------k-----T--SX-#X-T-------X----XXX--@-X----X----X---X--XX
----#-XX-------X----------XS-X--X----------T----------X-T-------X#-t-----------X---------XXXX----------------X---X-------------S---------X------t--X--
----X--XT----X-X----X--X--------XX----X---XX-------------------------------XX#--------------X-----T-------------X--X-#-#-S--------KX-X----X----g-XXX--
------X-------X-----XX--X-X--T-XX-------X-XXT----X------X-XX-#--X--X--#--------X-X-------------X---X-X--X--X--XX-----XX---X--X---X-X--X----------X-X-X
XXXX--X-XX-----X---------XX----X---XX---X--------------X-----X---X-XXX#--XX---S-#g-------#X-X-t--XX-----X---X----X-----X--X-X--XXXTX---X------X-XX----
XXXXt#--X--X--#X---XXX#X-XX-X----X#----C---X-SX---!X-----XT-------X---X--X--S-XX--------!-----X---XS---Xg-X--X----XXK---S-X----S-X--##------------XX--
