-----X*--X--#X-X--------------X----X----X----!-----X-X-TF----------X------#---------XX--X---X------X------#---X-X---X-----L-----XX------------X------X
-----------X-----X-------t------X-X--#-----#------------X--------X--X-----g-#X---------X--------X-S----XX--X---XX--#---X-X-----X----X--------X----X---
-------X--------X--------------#---------X--------------------R-X---------------X-X---X---------G--X--t----------X---|---y--------X------X-!---X----X-
----X2-----X-----X-X------#XX-----T-------------------X--X-----T---------X----X-------X-X----X--X-X-------------X-X-T--#----#TX------------------X----
------X----XX------X--------X-----------X-S-----T----C----------#-#---X-----T---k----------XXX-#-X-S-X----X------X-X-XX---X#-X-X----K----------------X
-------------------SX--X----X-------XX----X-X-----X------X-----------X----------#----------T--------X---X--X--*--X-XTX----XX--------S--------t----XT--
------#-X------X--G------X-------X--#--XX------!X-X------XX--X---X#-------------t--X---------#-------@--------g-X----X----X-----X---------------X-----
---------------X------------#X---1----------------XX----------X----------#-----------#-----X-----X---X-----X-X--#-X--X--S---------------S-------------
--------------------X--X------X---XX-T--------X----XX-------------T-------X-----------X-----X-X--------------XX-X-----XU-------X--------X--X-X-----X--
-------------------XS-----#--g---X----F----XX--------------S--X-----X-X---XX--X-----X------------------X----XS-------------------R--t-----X--X----X--X
-----X----t----------X--------------------K---X------TX----------------------X--X--X----k#--Xg-----XX-X---S-----X--X-#-----------#---------------X----
-------XT---XXT---------S---X-------X---XX-X------T----------F------#--tTX---X-------X---Kg------X-X----X--U--X--X---------#--TXT-------X-----------X%
------------U----X---X-------X-X-T1--X--------XK----X---X--#-------X----X#-#--------------#X----X------------------X--X-X---X!----X-S---X---X-----X---
-------------#--@X---X---------------#X-X-#-----X-----TX---#X-X-*--X----X--X------X---X----X----X----------X----------------------gS#-X-----------X---
XXXX-------------------X---X--X#-----------XX---X-XX----------X-----X--T-----X--------XX----X-T----------X---X-T---------------X------X---------X----#
XXXX-----g--X-----------X--X---X----------------------X---X----------X------X--X--------C--X-X-------X------X--X------X---XX!-#-X----#----r---#-------
