----------X-----X-X-------#-S----S----X---X-#--X-SXT-----X-X--X----------------X----------X-X-X---------X#X-X--------X---X#X--X----XX-X----X-T#X--!X--
------X--X--------X----------XX---T-----X----X-XX-X--------X---------XX--------------X--------X---S--XXX-XX------X----------XX------#-----X--X-X-X-kX-
----g----T-----X--X--X-SS-------------XX----T--X--------#---g--X---------------XX--Xt--X-X#---X-#---X------X--X----X--XX--T--X---------g------T---SS--
-------X---S-X-XXX------X---S-X-X--XX-----#-X-----#X-----X#----X------Xg---T-X--X---XX-X---XX-X--X--------X-XX----------X-X-X#X-----X-X---X--------X--
-------#-----X------X--#---------X----------X-X-----X--------X-----XS-tX----X-------XX----XX--T------FX-----X----------------------X---X---X------gg-X
------X--XX----X-------X-X--XS#--X--X--tXXX#X-X-X----X-X------#-S-----#----U---X-X-XX-X--#--X----------X--SXX--XgX-X-----TX-X----X--T-#--------M-X-#--
--------#-XX----#----------X-!XXX#--------X--X!---X--S---------T---------X--T--X----XX--X---#--X---X--X-#X-@-X------X--X-----TX--X---S--U#g-----------
-----TX-X---g---X---X--------g-X!---X-X--SXX----XX----X---------X--X-g-X----#----------!--X------tXX-X#----XX---X---X----------X---X-X-----#!X-X-XX--S
----XX--tX--X--XS-X----------X-XX----X----------T---X-X---X-------------X----#-g----X-X#---X---X------X-----Xg-X-S-#-X--#X--X-#---g-X------X---------X
-----X--XX-XX-X------X-------------SX-XX--#-----X-----X-----T-------------X-X---------------#---tX---------#---t-X------------------------XXXX---X--X-
------X---X----X-X-Xt-S---------X--X#--#XXX---XTX--XX--X!---X---X-X--------X----tK-X----g----tX--------XX------------------XX-----XgXX-X--#-----XXX---
---------XXX-X-----X---XS----S------!---X#X----t---X-X----X----X#X----X#XX-XTX-----------X-X!---XtX-#--S-----U-TXX---X-------X-X--X--XX---------------
----------X--X--T-X-XX--------XX-X--------X---t-X----#-----XX----X-X----X----X--T--X----------X----X--------X-X------X------------T----X--X--X----XXX-
--------t--XX----------X-----XXX-X-XXX----X-T---XX--XX----!----XX2-X-------X--#--#---------X----X-X------XtX---X----X---X----T-XX-X-X---------X--X----
XXXX-------XX-----!XX-X---#-X-----SX--X--------#-----X-----S-X-S-----X-------X-!-X-------------XX-----T--X-----------------g-T----X-------------X---XX
XXXX-----t--XXX--X-!X-------t--X---X-#--X--#--X--------g--X------X-------------X--X----S---------XXX-----#--X-tX--K-------X-S---------X--X------X-----
