----T----------X--------X--!-------------#-----X--#---X---XTX---------#--X-XX----XX##-------X-X--XSX--X-XX-----X-------X------#---------XX--X--X----X-
-----T-X-#---g-----------X--------X-X--X--X--------X--------X--X--X-------X--g-X------XXX------#-X---X----T-----------T#--#------------Xt-----#------X
----XX----K-----T-------X#--#-X---------t----------X--------X-X---XX---!X-g----X--X--X--g--C--S-X---------X#X-----------X-----XX-----X--X--XX--------X
-----X---X-t-kX--X-!--X--X----X--XX----XX----X-#XXt-----U---X-------X-X------X-X--XkXX--X----X---------XT------X-X-T--T--X----X----------#-----X--X-#-
-------X--X-----X-X---XX--#X----X-#XX-------------X---------t------#-#---XX----S#--------X----X-------X---X----XXX--X-----X--X-t-XX---X-X-----X-------
------S---X---------X---------------X#---X-!X-X-g-XX---Xt--X--X---X-X----X---X-X-------X---X-X#--X--------X-------X---------X----X-XX--S--#X--S--T-X--
------#-Xt--------X--g-----X-X-X----TX----X-----S-X#-X----X---#-------#X--X----------X-------------X--!XX--X-X----X--X--X-X--------kX--XXX-----!------
------X-----XX-----X-gSTX--T-------XX-X----X--X--XXX-----S-T--#--X--------g-t-------X--X--------X---X-X-X-------------t--X--#XX-------XXXX--X---X-----
-----X--X--X-XXX--------t-SX---X---#g-X-XX------X-----X-X---X--XS!X--X-------------------XX----X-S--X-----------X-X-X--t-k-XXt----t--X----------X--X-#
---------------T-----#---g-----XX-X-----X#-X--X-----X--#---------t--------------X--XXk-XX-X---X-------X-------------XXX---XXX-T-TS-----X-------X------
-------------X---------X----S---------XS---------X-#------X---X----X------F-------K---------S-------------------#-----------------!----X----------X---
----X------X-X-----------#---X-X--X------X---XX-------X--!-----X-----g-T--X-S----X-------X-X!----X----t-X------SXX-----XX--XX--X--T---X---!----XX--X-X
-----XX--X--XXXTg-X------XX--X-XCXX-----t-X-------X---S-#------X---XS-----X--X---X-XXk-X----------X----Xg#----X--X-X-------X----------XX-XXX--X---XX--
---------XX-----#X--X--!------------X-X-XX---X-X---Xg-T--X--X-XX----K-XXX-X----X--------!-------------------XX#X#-X--X-XX---#---X-------X-------X--S-X
XXXX-S--------X-XT-t----X--XX------X-----------X---X---tXX-X---X!XX--KT----#X---XX-XT-------X----X--X--X---#X---#X---X--X-t-------XX----#--------X-Xg-
XXXXX-X-X--##X-X-------X--X--#--X--#-X-X------XX---Xt!X---------T-X-X--X-----X--X---X------X---X------S-------X--X--------------X---XST-----X-X--XKXX-
