-------------------------------------------------------------------------------------------------------------------------------
-------------------------------------------------------------------------------------------------------------------------------
-------------------------------------------------------------------------------------------------------------------------------
-------------------------------------------------------------------------------------------------------------------------------
-------------------------------------------------------------------------------------------------------------------------------
-------------------------------------------------------------------------------------------------------------------------------
--------------------------------------------------------------------------------------------------------------------##---------
--------------------------------------------------------------------------------------------------------------------##---------
-----------------------------------------------------------------------------------TT-------------------------------##---------
-----------------------------------------------------------------------------------TT------------------------K---#--##---------
--------------------------------------------------------------------------#LSS-----##---------------------------##--##---------
-------K--------------------TT-----TT----K--------------------------------#------------------------------------###--##---------
----------------------------TT-----TT-------------------------------------#-----------*---TT-----*------------####------------F
--M-----------ggg---------kkTT-----TT-----------ggg-------ggg-----------kk#-----------*---TT-----*-----K-----#####------------#
XXXXXXXXXXXXXXXXXXXXXXXXXXXXXXXXX--XXXXXXXXXXXXXXXXXXXXXXXXXXXXXXXXXXXXXXXXXXXX---XXXXXXXXXXXXXXXXXXXXXXXXXXXXXXXXXXXXXXXXXXXXX
XXXXXXXXXXXXXXXXXXXXXXXXXXXXXXXXX--XXXXXXXXXXXXXXXXXXXXXXXXXXXXXXXXXXXXXXXXXXXX---XXXXXXXXXXXXXXXXXXXXXXXXXXXXXXXXXXXXXXXXXXXXX
