------------------------------------------------------------------------------------------------------------------------------------------------------------------------------------------------------------------------------------------------------
------------------------------------------------------------------------------------------------------------------------------------------------------------------------------------------------------------------------------------------------------
------------------------------------------------------------------------------------------------------------------------------------------------------------------------------------------------------------------------------------------------------
------------------------------------------------------------------------------------------------------------------------------------------------------------------------------------------------------------------------------------------------------
------------------------------------------------------------------------------------------------------------------------------------------------------------------------------------------------------------------------------------------------------
------------------------------------------------------------------------------------------------------------------------------------------------------------------------------------g--------------------r--------------------------------------------
---------------------LSSS---------------------!!!!!-----------USSS--------SSCSS------SSSS-----------------------------USSS--------------------------SSCCCCCCCCCCCCCSCCCCCCCCCCCCCCCCSSS---SSSS--SSSSSSSSSSSSS----------SSC----------------------------
--------------------------------------------------------------------------------------------------------------------------------------------------------------------------------------K---------------------------------------------------------------
-----------------g----------------------------------------------------------------------------------------------------------------------------------------------------------------------------------------------------------------g#------------------
-----------------#------------------------------k-----------------------------------------------g--------------------------TT---------------------------------------------------------------------------k-k----#-------SSS--------##------------------
-----S--SUS-----##---2-----#-----------TT-----@!!!!----------S-----TT---!!!!--!!!---------------TT-----------------TT------TT-------------------------@SSSSSSSSSSSSSSSSSSSSSSSSSSSSSSS--#C--------------CCCCCCC#-----------------###------------------
---------------###---------#-----------TT--------------------------TT---------------------------TT----------g------TT--tt--TT----------------------------------------------------------##---------------------------------------####------------------
--------------####---------##----------TT--------------------------TT---------------------------TT----------TT-----TT--tt--TT------------------K--------------------------------------###--------------------------------------#####-----------------F
--M----------####-----kk---##---gg-----TT------------gg----k-ggg---TT------------ggg------------TT----------TT--g--TT--tt--TT-----k--------------------------------------------------####----------#-----kk--------------------#####--------#--------X
XXXXXXXXXXXXXXXXXXXXXXXXXXXXXXXXXXXXXXXXXXXXXXXXXXXXXXXXXXXXXXXXXXXXXXXXXXXXXXXXXXXXX----XXXXXXXXXX---XXXXXXXXXXXXXXXXXXXXXXXXXXXXXX---XXXXXXXXXX---XXXXXXXXXXXXXXXXXXXXXXXXXXXXXXXXXXXXXXXXX------XXXXXXXXXXXXXXXXXXX----XXXXXXXXXX--XXXXXXXXXXXXXXXX
XXXXXXXXXXXXXXXXXXXXXXXXXXXXXXXXXXXXXXXXXXXXXXXXXXXXXXXXXXXXXXXXXXXXXXXXXXXXXXXXXXXXX----XXXXXXXXXX---XXXXXXXXXXXXXXXXXXXXXXXXXXXXXX---XXXXXXXXXX---XXXXXXXXXXXXXXXXXXXXXXXXXXXXXXXXXXXXXXXXX------XXXXXXXXXXXXXXXXXXXX---XXXXXXXXXX--XXXXXXXXXXXXXXXX
