------------------------------------------------------------------------------------------------------------------------------------------
------------------------------------------------------------------------------------------------------------------------------------------
------------------------------------------------------------------------------------------------------------------------------------------
------------------------------------------------------------------------------------------------------------------------------------------
-------------------------------------------------------------------------------------------------------------------------------XX---------
-------------------------------------------------------------------------------------------------------------------------------XX---------
---------------------LSSS---------------------!!!!!-----------USSS-----------------------------------SSSSS---@-------------C---XX---------
-------------------------------------------------------------------------------------------------------------------------------XX---------
-----------------g-------------------------------------------------------------------------------------------------------------XX---------
-----------------#------------------------------k------------------------------------------------------------------------------XX---------
--------SUS-----##---2-----#-----------TT-----@!!!!----------S-----TT-----------------------------C--------!--------------SS---XX---------
---------------###---------#-----------TT--------------------------TT----------------------#---------------------TT------------XX---------
--------------####---------##----------TT--------------------------TT------------------K---#---------------------TT------------XX--------F
--M----------#####----kk---##---gg-----TT------------gg----k-ggg---TT-----k----------------#-----gg-------K-K----TT--------k---XX--------X
XXXXXXXXXXXXXXXXXXXXXXXXXXXXXXXXXXXXXXXXXXXXXXXXXXXXXXXXXXXXXXXXXXXXXXXXXXXX---XXXXXXXXXX--XXXXXXXXXXXXXXXXXXXXXXXXXXXXXXXXXXXXXXXXXXXXXXX
XXXXXXXXXXXXXXXXXXXXXXXXXXXXXXXXXXXXXXXXXXXXXXXXXXXXXXXXXXXXXXXXXXXXXXXXXXXX---XXXXXXXXXX--XXXXXXXXXXXXXXXXXXXXXXXXXXXXXXXXXXXXXXXXXXXXXXX
