---------------------------------------------------------------------------------------------------
---------------------------------------------------------------------------------------------------
---------------------------------------------------------------------------------------------------
---------------------------------------------------------------------------------------------------
---------------------------------------------------------------------------------------------------
----------------------------------------------------------------------------------------##---------
---------------------LSSS--------------------------------------------------------------###---------
--------------------------------------------------------------------------------------####---------
-----------------g-------------------------------------------------------------------#####---------
-----------------#------------------------------------------------------------------######---------
--------SUS-----##---2-----#-----------------------------------TT------------------#######---------
---------------###---------#------B----------------------------TT--------TT-------########--------F
--------------####---------##-----b-----TT----K----TT----------TT-----r--TT----g-#########--------#
--M----------#####----kk---##-----b-----TT---------TT--------XXXXXXXXXXXXXXXXXXXXXXXXXXXXXXXXXXXXXX
XXXXXXXXXXXXXXXXXXXXXXXXXXXXXXXXXXXXXXXXXXXXXXX-XXXXX-X------XXXXXXXXXXXXXXXXXXXXXXXXXXXXXXXXXXXXXX
XXXXXXXXXXXXXXXXXXXXXXXXXXXXXXXXXXXXXXXXXXXXXXX-XXXXX-X--------------------------------------------
