----------------------------------------------------------------------------------
----------------------------------------------------------------------------------
----------------------------------------------------------------------------------
----------------------------------------------------------------------------------
----------------------------------------------------------------------------------
-----------------------------------------------------------------------y----------
-----------------------------------------------------------------------##---------
---------------------------------------------------------------------y###---------
-----------------g---------------------------------------------------####---------
-----------------#--------------------------------------------------#####---------
--------SUS-----##-------------------------------------------------######---C-----
---------------###---------------------------#--------------------#######---------
--------------####---------------------------#-------------------########--------F
--M----------#####---------------------------#----y--y----------#########--------#
XXXXXXXXXXXXXXXXXXXXXXXXXXXXXX---XXX--XXXXXXXX--XXXXXXXXXXXXXXXXXXXXXXXXXXXXXXXXXX
XXXXXXXXXXXXXXXXXXXXXXXXXXXXXX---XXX--XXXXXXXX--XXXXXXXXXXXXXXXXXXXXXXXXXXXXXXXXXX
