---------------------------------------------------------------------------------------------------------------------------------------------------------------------------------------------------------------------------------------------------------------------------------------------------------------------------------------
---------------------------------------------------------------------------------------------------------------------------------------------------------------------------------------------------------------------------------------------------------------------------------------------------------------------------------------
---------------------------------------------------------------------------------------------------------------------------------------------------------------------------------------------------------------------------------------------------------------------------------------------------------------------------------------
---------------------------------------------------------------------------------------------------------------------------------------------------------------------------------------------------------------------------------------------------------------------------------------------------------------------------------------
---------------------------------------------------------------------------------------------------------------------------------------------------------------------------------------------------------------------------------------------------------------------------------------------------------------------------------------
---------------------------------------------------------------------------------------------------------------------------K------------------------------------------------------------------------------------------------------------------------------------------------------------------------------------------------##---------
---------------------LSSS----------------------------------------------------!-!-----------------------------------------SSSSSSS@-------------------------------r--------------------------------------------------------------SUS--------------------------------------LSSSS----------------TT----------------------------###---------
-------------------------------------------------------------------------------------------------------------------------------------------------------------SSSSS--------------CCSS-----------------------------------------------------S---------------------------------------------------TT---------------------------####---------
-----------------g----------------------------------------------------------------------------------------------------------------------------------------------------------------------------------------------------------------------------------------------------------------------k----TT--------------------------#####---------
-----------------#-------------------------------------oo---------------------------------------------------------------------K-------------------------------------------------------------------------------------------------------------------------------SSUSSUSSUS--tt------------TT--CCC@------------------------######---------
--------SUS-----##---2-----#--------------------------o--o-------------------!-!-----------------------------------------SSSSSSSS-------------------------------------------@-------------------------------------------------#####-------------------------------------2-tt------------TT-----------------------------#######---------
---------------###---------#------TT--------------------------------------------------------------------K---------------------------#------------------SSS---------------KK------------------TT-------------------------------#------------------K------------------------tt------------TT-------------------TT-------########--------F
--------------####---------##-----TT------K---------------------------------------------------------------B-----------TT------------#------------C@------------------------------TT----------TT------------------------------K#----------#-----------K--------------------tt------------TT-----r----------r--TT----g-#########--------#
--M----------#####----kk---##-----TT-------------------------------y-------------y------------------------b-ggg-------TT------------#----yyy-------------------gg----------------TT----------TT------ggg--r----ggg------------#----------#--------------------------------XX--XXXXXXXXXXXXXXXXXXX---XXXXXXXXXXXXXXXXXXXXXXXXXXXXXXXXXXX
XXXXXXXXXXXXXXXXXXXXXXXXXXXXXXXXXXXXXXXXXXXX---XXXXXXXXXXXXXXXXXXXXXXXXXXXXXXXXXXXXXXXXXXXX----XXXXXXXXXXXXXXXXXXXXXXXXXXXXXXXXXXX--XXXXXXXXXXXXXXXX-------XXXXXXXXXXXXXXXXXXX---XX--XXXXXXXXXXXXXXXXXXXXXXXXXXXXXXXXXXXXXXXXXXXX----XXXXXXXXX-X-XX-X-XX-XXXXXXXXXXXXXXXX-XX--XXXXXXXXXXXXXXXXXXX---XXXXXXXXXXXXXXXXXXXXXXXXXXXXXXXXXXX
XXXXXXXXXXXXXXXXXXXXXXXXXXXXXXXXXXXXXXXXXXXX---XXXXXXXXXXXXXXXXXXXXXXXXXXXXXXXXXXXXXXXXXXXX----XXXXXXXXXXXXXXXXXXXXXXXXXXXXXXXXXXX--XXXXXXXXXXXXXXXX-------XXXXXXXXXXXXXXXXXXX---XX--XXXXXXXXXXXXXXXXXXXXXXXXXXXXXXXXXXXXXXXXXXXX----XXXXXXXXX-X-XX-X-XX-XXXXXXXXXXXXXXXX--------------------------------------------------------------
