-----------------------------------------------------------
-----------------------------------------------------------
-----------------------------------------------------------
-----------------------------------------------------------
------------------------------------------------XX---------
------------------------------------------------XX---------
---------------------LSSS-------------------C---XX---------
------------------------------------------------XX---------
-----------------g------------------------------XX---------
-----------------#------------------------------XX---------
--------SUS-----##---2-----#----------------S---XX---------
---------------###---------#------TT------------XX---------
--------------####---------##-----TT------------XX--------F
--M----------#####----kk---##-----TT------t-k---XX--------X
XXXXXXXXXXXXXXXXXXXXXXXXXXXXXXXXXXXXXXXXXXXXXXXXXXXXXXXXXXX
XXXXXXXXXXXXXXXXXXXXXXXXXXXXXXXXXXXXXXXXXXXXXXXXXXXXXXXXXXX
