---------------------------------------------------------------------------------------------------------------------------------------------------------------------------------------------------------------------------------------------------------------------------------------------------------------------------------------------------------------------------------------------------------------------------------------------------------------------------------------------------------------
---------------------------------------------------------------------------------------------------------------------------------------------------------------------------------------------------------------------------------------------------------------------------------------------------------------------------------------------------------------------------------------------------------------------------------------------------------------------------------------------------------------
---------------------------------------------------------------------------------------------------------------------------------------------------------------------------------------------------------------------------------------------------------------------------------------------------------------------------------------------------------------------------------------------------------------------------------------------------------------------------------------------------------------
--------------------------------------------------------------------------------------------------------------------------------------------------------------------------------------------------------------------------------------------------------------------------------------------------------------------------------------------------------------------------------------------------------1-------------------------------------------------------------------------------------------##---------
-------------------------------------------------------------------------------------------------------------------------------------------------------------------------------------------------------------------------------------------------------------------------------SSSS----------------------------------------------------------------------------------------------------------------------------------oooo----------oooo------------------------------------------------------------###---------
--------------------------------------------------------------------------------------------------------------------------------------------------------------------------------------------------------------------------------------------------------------------------------------------------------------------------------------------------------------------------------------------------------------------------------------------------------------------------------------------------####---------
---------------------LSSS---------------------!!!!!----------------------------------------------------------------USS------------------SS!SSS@SSS--------------------------------------------------------------------------------------------------------------------------------------------------------------------------------------------------------------------------------------g#-------------------------------------------------------------------------------------------------------#####---------
------------------------------------------------------------------------------------------------------------------------------------------------------------------------------------------------------------------------------------------------------------------------------------------------------------------------B---------------------------------------------------K-----------##------------!!!!----------------------TT--------------------------------------------------------------######---------
-----------------g-----------------------------------------------------------#----------------------------------------------------------------------------------------------------------------------------------------------------------------------------g#----------------------------------------S@---------SS------S#2---------------------------------TT---------K---------------g###----B--------------------#------------TT--------------K----------------#-----------------------------#######---------
-----------------#------------------------------k---------------------------##--oo------o----o--------------------------------------------K-----------------------------------------------B---------------------------------------------------K-----------##--------------------------#-------B-------------------------------B----------------------------TT-----TT-----K----B-------####----b--------------------#------------TT--------------------------B----#----------------------------########--------F
--------SUS-----##---2-----#-----------TT-----@!!!!------------------------###------------------------------------#-------------TT------SSSSSSSSSSS-------------------S@---------SS------S#2---------------------------------TT---------K---------------g###----B-----------#---------#-----K-bK----------B-------------------b-----TT----K----TT----------TT-----TT----------b------#####-y--B--------yy----------#---------y--TT---y------y--------ggg----b----#----ggg--k----ggg------ggg-#########--------#
---------------###---------#-----------TT---------------------------------####------------------------------------#-------------TT------------------------------B-------------------------------B----------------------------TT-----TT-----K----B-------####----b-----------#-X-------#-------B-----------b--y------B--y-y----b-----TT---------TT--------XXXXXXXXXXXXXXXXXXXX-X---XXXXXXXXXXXXXXXXXXXXXXXXXXXXXXXXXXXXXXXXXXXXXXXXXXXXXXXXXXXXXXXXXXXXXXXXXXXXX--XXXXXXXXXXXXXXXXXXXXXXXXXXXXXXXXXXXXXXXXXXXXXX
--------------####---------##----------TT--------------------------------#####----------------------#---#---------##------------TT----------------------B-----K-bK----------B-------------------b-----TT----K----TT----------TT-----TT----------b------#####-y--B------ggg--#XX----XXXXXXXXXXXXXXXXXXXXXXXXXXXXXXXXXXXXXXXXXXXXXXXXXXXXXXXX-XXXXX-X------XXXXXXXXXXXXXXXXXXXX-X---XXXXXXXXXXXXXXXXXXXXXXXXXXXXXXXXXXXXXXXXXXXXXXXXXXXXXXXXXXXXXXXXXXXXXXXXXXXXX--XXXXXXXXXXXXXXXXXXXXXXXXXXXXXXXXXXXXXXXXXXXXXX
--M----------#####----kk---##---gg-----TT------------gg----k-ggg------gg######--k-------------------#-k-#---------##--gg----k---TT--------------K-------b-------B-----------b--y------B--y-y----b-----TT---------TT--------XXXXXXXXXXXXXXXXXXXX-X---XXXXXXXXXXXXXXXXXXXXXX-XXXX----XXXXXXXXXXXXXXXXXXXXXXXXXXXXXXXXXXXXXXXXXXXXXXXXXXXXXXXX-XXXXX-X------------------------------------------------------------------------------------------------------------------------------------------------------------
XXXXXXXXXXXXXXXXXXXXXXXXXXXXXXXXXXXXXXXXXXXXXXXXXXXXXXXXXXXXXXXXXXXXXXXXXXXXXXXXXXXXXX---XX---XXXXXXXXXXXXXXXX----XXXXXXXXXXXXXXXXXXXXXXXXXXXXXXXXXXXXX-XXXXXXXXXXXXXXXXXXXXXXXXXXXXXXXXXXXXXXXXXXXXXXXXXXXXX-XXXXX-X------XXXXXXXXXXXXXXXXXXXX-X---XXXXXXXXXXXXXXXXXXXXXX-XXXX--------------------------------------------------------------------------------------------------------------------------------------------------------------------------------------------------------------------------------
XXXXXXXXXXXXXXXXXXXXXXXXXXXXXXXXXXXXXXXXXXXXXXXXXXXXXXXXXXXXXXXXXXXXXXXXXXXXXXXXXXXXXX---XX---XXXXXXXXXXXXXXXX----XXXXXXXXXXXXXXXXXXXXXXXXXXXXXXXXXXXXX-XXXXXXXXXXXXXXXXXXXXXXXXXXXXXXXXXXXXXXXXXXXXXXXXXXXXX-XXXXX-X------------------------------------------------------------------------------------------------------------------------------------------------------------------------------------------------------------------------------------------------------------------------------------------
