------------------------------------------------------------------------------------------------------------------------------------
------------------------------------------------------------------------------------------------------------------------------------
------------------------------------------------------------------------------------------------------------------------------------
------------------------------------------------------------------------------------------------------------------------------------
------------------------------------------------------------------------------------------------------------------------------------
------------------------------------------------------------------------------------------------------------------------------------
---------------------LSSS---------------------!!!!!------------SSSSS---@--------------S---------------------------------------------
----------------------------------------------------------------------------------TT-----------------CCSS----------------##---------
-----------------g----------------------------------------------------------------TT----------------------------------K-###---------
-----------------#------------------------------k---------------------------------TT------------------------------------###---------
--------SUS-----##---2-----#-----------TT-----@!!!!---------C--------!-----------SXXS------------@--------------------#-###---------
---------------###---------#-----------TT----------------------------------TT-----------------KK---------------------##-###---------
--------------####---------##----------TT----------------------------------TT---------TT--------------TT-----------#-##-###--------F
--M----------#####----kk---##---gg-----TT------------gg----gg-------K-K----TT---------TT--------------TT----------##-##-###--------#
XXXXXXXXXXXXXXXXXXXXXXXXXXXXXXXXXXXXXXXXXXXXXXXXXXXXXXXXXXXXXXXXXXXXXXXXXXXXXXXXXXXXXXXXXXXXXXXXXXX---XX--XXXXXXXXXX-XX-XXXXXXXXXXXX
XXXXXXXXXXXXXXXXXXXXXXXXXXXXXXXXXXXXXXXXXXXXXXXXXXXXXXXXXXXXXXXXXXXXXXXXXXXXXXXXXXXXXXXXXXXXXXXXXXX---XX--XXXXXXXXXX-XX-XXXXXXXXXXXX
