----------------------------------------------------------------------------------------------------------------------------------------------------------------------------------------------------------------------------------------------------------------------------------------------------------------------------------------------------------------------------------------------------------------
----------------------------------------------------------------------------------------------------------------------------------------------------------------------------------------------------------------------------------------------------------------------------------------------------------------------------------------------------------------------------------------------------------------
----------------------------------------------------------------------------------------------------------------------------------------------------------------------------------------------------------------------------------------------------------------------------------------------------------------------------------------------------------------------------------------------------------------
----------------------------------------------------------------------------------------------------------------------------------------------------------------------------------------------------------------------------------------------------------------------------------------------------------------------------------------------------------------------------------------------------------------
-------------------------------------------------------------------------------------------------------------------------------------------------------------------------------------------------------------------------------------------------------------------------------------------------------------oo-------------------------------------------------------------------------------------------------
------------------------------------------------------------------------------------------------------K--------------------------SSS----S!!S--------------------------------------------------------------------------------------------------------------------------------------------------------------------------------------------------------------------------------------------------------------------
---------------------LSSS-------!!!!--------------------!-!-----------------------------------------SSSSSSS@----------------------------------------------------------------------------------------------------------------------------------------------------------------------------------------------------------------------------------------------------------------------------------------------------
----------------------------------------------------------------------------------------------------------------------------------------------------------------------------------------------------------------------------------------------------------------------------------------------------------------------------------------------------------------------------------------------------------------
-----------------g----------------------------------------------------------------------------------------------------------------------------------------------------------------------------------------------------------------------------------------------o---------------1--------o--------o--------------------------------------------------------------------------------------------o---------------1
-----------------#----------------y----------------------------------------------------------------------K-------------------------------SS------#--#----------##--#------------SS!S----------------------------------------------------------------------------------------TT----------------TT--------TT-------------------------------------------------------------------------------------------------TT---
--------SUS-----##---2--------!!@SS!!!------------------!-!-----------------------------------------SSSSSSSS------------------------------------##--##--------###--##-----------------------------------------------------TT----TT------------------------------------------TT----TT----------TT--------TT---------------------------------------------TT-----TT----K--------------------------------------TT---
---------------###-----------------------------------------------------------------K---------------------------#-------------------------------###--###------####--###-----tt--------------tt-----------------------------TT----TT------------------------------------------TT----TT----------TT--------TT---------tt----------------------------------TT-----TT-------------------------------------------TT---
--------------####-------------------------------------------------------------------B-----------TT------------#------------C@------gg-g-g----####--####----#####--####----tt---------gg---tt-k----kkk---kkk---kkk--------TT----TT---------ggg--------ggg------------ggg----TT---kTT----------TT--------TT---ggg---tt-k----kkk---kkk------gg---------kkTT-----TT-----------ggg-------ggg------------ggg----TT---
--M----------#####----kk----------------------y-------------y------------------------b-ggg-------TT------------#----yyy--------TXXXXXXXXXXXXXXXXXXXXXXXXXXXXXXXXX--XXXXXXXXXXXXXXXXXXXXXXXXXXXXXXXXXXXXXXXXXXXXXXXXXXXXXXXXXXXXXXXXXXXXXXXXXXXXXXXXXXXXXXXXXXXXXXXXXXXXXXXXXXXXXXXXXXXXXXXXXXXXXXXXXXXXXXXXXXXXXXXXXXXXXXXXXXXXXXXXXXXXXXXXXXXXXXXXXXXXXXXXX--XXXXXXXXXXXXXXXXXXXXXXXXXXXXXXXXXXXXXXXXXXXXXXXXXX
XXXXXXXXXXXXXXXXXXXXXXXXXXXXXXXXX--XXXXXXXXXXXXXXXXXXXXXXXXXXXXXXXXXXX----XXXXXXXXXXXXXXXXXXXXXXXXXXXXXXXXXXX--XXXXXXXXXXXXXXXXTXXXXXXXXXXXXXXXXXXXXXXXXXXXXXXXXX--XXXXXXXXXXXXXXXXXXXXXXXXXXXXXXXXXXXXXXXXXXXXXXXXXXXXXXXXXXXXXXXXXXXXXXXXXXXXXXXXXXXXXXXXXXXXXXXXXXXXXXXXXXXXXXXXXXXXXXXXXXXXXXXXXXXXXXXXXXXXXXXXXXXXXXXXXXXXXXXXXXXXXXXXXXXXXXXXXXXXXXXXX--XXXXXXXXXXXXXXXXXXXXXXXXXXXXXXXXXXXXXXXXXXXXXXXXXX
XXXXXXXXXXXXXXXXXXXXXXXXXXXXXXXXX--XXXXXXXXXXXXXXXXXXXXXXXXXXXXXXXXXXX----XXXXXXXXXXXXXXXXXXXXXXXXXXXXXXXXXXX--XXXXXXXXXXXXXXXX---------------------------------------------------------------------------------------------------------------------------------------------------------------------------------------------------------------------------------------------------------------------------------
