------------------------------------------------------------------------------------------------------------------------------------------------------
------------------------------------------------------------------------------------------------------------------------------------------------------
------------------------------------------------------------------------------------------------------!----------------##-----------------------------
----------------------------------------------------------------------------------------------------------------------###-----------------------------
---------------------------------------------------------------------------------------------------------------------####-----------------------------
--------------------------------------------------------------------------------------------------------------------#####----------------------------#
------------------------------!-!--------------------!----------------------------------------------SS!------------######--------------------S-----TT#
------------------------------------------------------------------------------------------------------------------#######-------------------------#TT#
--------------------------------------------------------------------------------------------------------------tt-########--------F---------------##TT#
---------------------------------------------------------------------------------------------------------gg---tt#########--------#--------------###TT#
------------------------------!-!--------------!---S@S!S--------------------TT-----TT-------TT----!!!@XXXXXXXXXXXXXXXXXXXXXXXXXXXXXXXXXXXXXXXXXXXXXXXX
------------#---------------------------------------------------------------TT-----TT-----TTTT--------XXXXXXXXXXXXXXXXXXXXXXXXXXXXXXXXXXXXXXXXXXXXXXXX
------------#----------------------------------------------tt---------------TT-----TT---TTTTTT--------------------------------------------------------
------------#----y--y-------------y-----------------g------tt--------ggg----TT-----TT---TTTTTT--------------------------------------------------------
XXXXXXXXXXXXX--XXXXXXXXXXXXXXXXXXXXXXXXXXXXXXXXXXXXXXXXXXXXXXXXXXXXXXXXXXXXXXXXXXXXXXXXXXXXXXXXXXXXXXX------------------------------------------------
XXXXXXXXXXXXX--XXXXXXXXXXXXXXXXXXXXXXXXXXXXXXXXXXXXXXXXXXXXXXXXXXXXXXXXXXXXXXXXXXXXXXXXXXXXXXXXXXXXXXX------------------------------------------------
