---------------------------------------------------------------------------------------------------------------------------------------------------------------------------------------------------
---------------------------------------------------------------------------------------------------------------------------------------------------------------------------------------------------
---------------------------------------------------------------------------------------------------------------------------------------------------------------------------------------------------
---------------------------------------------------------------------------------------------------------------------------------------------------------------------------------------------------
---------------------------------------------------------------------------------------------------------------------------------------------------------------------------------------------------
------------------------------------------------------------------oo-----------------------------------K-------------------------------------------------------------------------------------------
---------------------LSSS----------------------------------------SSS---------------------------------SSSSSSS@-------------------------------r-------------------------------------------##---------
-----------------------------------------------------------------------------------------------------------------------------------------SSSSS--------------CCSS-----------------------###---------
-----------------g------------------------------##------------------------------------------------------------------------------------------------------------------------------------####---------
-----------------#-----------------------------###------------------SSS-----------------------------------K--------------------------------------------------------------------------#####---------
--------SUS-----##---2-----#----------------#--###-------@@@@@-D-------------------------------------SSSSSSSS-------------------------------------------@---------------------------######---------
---------------###---------#------TT------g##--###----------------------------------K---------------------------#------------------SSS---------------KK----------------------------#######---------
--------------####---------##-----TT------###--###------------------------------------B-----------TT------------#------------C@------------------------------TT----------TT-------########--------F
--M----------#####----kk---##-----TT-----####--###-----------K------oo-------------g--b-ggg-------TT------------#----yyy-------------------gg----------------TT----------TT----g-#########--------#
XXXXXXXXXXXXXXXXXXXXXXXXXXXXXXXXXXXXXXXXXXXXX--XXXXXXXXXXXXXXXXXXXXXXXX----XXXXXXXXXXXXXXXXXXXXXXXXXXXXXXXXXXX--XXXXXXXXXXXXXXXX-------XXXXXXXXXXXXXXXXXXX---XX--XXXXXXXXXXXXXXXXXXXXXXXXXXXXXXXXXX
XXXXXXXXXXXXXXXXXXXXXXXXXXXXXXXXXXXXXXXXXXXXX--XXXXXXXXXXXXXXXXXXXXXXXX----XXXXXXXXXXXXXXXXXXXXXXXXXXXXXXXXXXX--XXXXXXXXXXXXXXXX-------XXXXXXXXXXXXXXXXXXX---XX--XXXXXXXXXXXXXXXXXXXXXXXXXXXXXXXXXX
