-----------------------------------------------------------------------------------------------------------------------------------------------------------------------------------------------------------------------------------------
-----------------------------------------------------------------------------------------------------------------------------------------------------------------------------------------------------------------------------------------
-----------------------------------------------------------------------------------------------------------------------------------------------------------------------------------------------------------------------------------------
-----------------------------------------------------------------------------------------------------------------------------------------------------------------------------------------------------------------------------------------
---------------------------------------------------------------------------------------------------------------------------------------------------------------------------------------k---------------------------------------k---------
------------------------------------------------------------------------------------------------------------------1-------USS------------------SS!SSS@SSS--------SSC------------------S!S--S!S--------------------------------##---------
---------------------LSSS----------------------------------------------------------------------------------------------------------------------------------------------------------------------------------------------------###---------
-------------------------------------------T--------------------------------------------------------------------------------------------------------------------------------g#---------------------------------#-----------k####---------
-----------------g-------------------------T----------------------------------------------------------------------ggg----------------------------K---------------SSS-------g##---------------------------k-----#-----------#####---------
-----------------#-------------------------X--------------SSS---------TT---------------------S--------------##########---#-------------TT------SSSSSSSSSSS-----------------###--------S!S--S@S--------SCSSS----#----------######---------
--------SUS-----##---2-----#-----------TT-------------------K---TT----TT-----------------TT----------------##--------#---#-------------TT---------------------------------####--------------------------K-----##---------#######---------
---------------###---------#-----------TT-----------------------TT----TT-----------------TT--------TT-----###--------#---##------------TT--------------------------------#####--------------------------------##--------########--------F
--------------####---------##----------TT-------------r--K------TT---gTT--------------gggTT------k-TT----####--------#---##--gg----k---TT--------------K----------------######------k------ggg--------K---K---##-------#########--------#
--M----------#####----kk---##---gg-----TT-------XXXXXXXXXXXXXXXXXXXXXXXXXXXXX---XXXXXXXXXXXXXXXXXXXXXXXXXXXXX--------X---XXXXXXXXXXXXXXXXXXXXXXXXXXXXXXXXXXXXXXX----XXXXXXXXXX--XXXXXXXXXXXXXXXXXXXXXXXXXXXXXXXX---XXXXXXXXXXXXXXXXXXXXXX
XXXXXXXXXXXXXXXXXXXXXXXXXXXXXXXXXXXXXXXXXXXXX---XXXXXXXXXXXXXXXXXXXXXXXXXXXXX---XXXXXXXXXXXXXXXXXXXXXXXXXXXXX--------X---XXXXXXXXXXXXXXXXXXXXXXXXXXXXXXXXXXXXXXX----XXXXXXXXXX--XXXXXXXXXXXXXXXXXXXXXXXXXXXXXXXX---XXXXXXXXXXXXXXXXXXXXXX
XXXXXXXXXXXXXXXXXXXXXXXXXXXXXXXXXXXXXXXXXXXXX--------------------------------------------------------------------------------------------------------------------------------------------------------------------------------------------
