--------------------------------------------------------------------------------------------------------------------------------------------------------------------------
--------------------------------------------------------------------------------------------------------------------------------------------------------------------------
--------------------------------------------------------------------------------------------------------------------------------------------------------------------------
--------------------------------------------------------------------------------------------------------------------------------------------------------------------------
--------------------------------------------------------------------------------------------------------------------------------------------------------------------------
---------------------------------------------------------------------------------------------------------------------------------------------------------------##---------
-----------------------------US-------------------------------1-----------------------------------------------------------------------------------------------###---------
-------------------------------------------------------------------------------------------------------------------------------------------------------------####---------
------------------------------------------------------------------------------------------------------------------------------------------------------------#####---------
---------------------------------------------------------------------------------------------------B-------------------------------------------------------######---------
---------!!-----------------####--SSC-----------------------!!!!---------------S@---------SS------S#2---------------------------------TT------------------#######---------
-----------------------y-#####-------------------------------------------B-------------------------------B----------------------------TT--------TT-------########--------F
--------------------y-######-------------------------------------------K-bK----------B-------------------b-----TT----K----TT----------TT-----r--TT----g-#########--------#
--M----------------#######------------------y-y--------------yy----------B-----------b--y------B--y-y----b-----TT---------TT--------XXXXXXXXXXXXXXXXXXXXXXXXXXXXXXXXXXXXXX
XXXXXXXXXXXXX--XXXXXXXXX------XX--XXXXXXXXXXXXXXXX--XXXXXXXXXXXXXXXXXXXXXXXXXXXXXXXXXXXXXXXXXXXXXXXXXXXXXXXXXXXXXXXXXX-XXXXX-X------XXXXXXXXXXXXXXXXXXXXXXXXXXXXXXXXXXXXXX
XXXXXXXXXXXXX--XXXXXXXXX------XX--XXXXXXXXXXXXXXXX--XXXXXXXXXXXXXXXXXXXXXXXXXXXXXXXXXXXXXXXXXXXXXXXXXXXXXXXXXXXXXXXXXX-XXXXX-X--------------------------------------------
