-------------------------------------------------------------------------------------------------------------------------------------------------
-------------------------------------------------------------------------------------------------------------------------------------------------
-------------------------------------------------------------------------------------------------------------------------------------------------
-------------------------------------------------------------------------------------------------------------------------------------------------
-------------------------------------------------------------------------------------------------------------------------------------------------
-------------------------------------------------------------------------------------------------------------------------------------------------
---------------------LSSS---------------------!!!!!-----------USSS-----------------------------------SSSSS---@-------------C----------##---------
-------------------------------------------------------------------------------------------------------------------------------------###---------
-----------------g------------------------------------------------------------------------------------------------------------------####---------
-----------------#------------------------------k----------------------------------------------------------------------------------#####---------
--------SUS-----##---2-----#-----------TT-----@!!!!----------S-----TT-----------------------------C--------!--------------SS------######---------
---------------###---------#-----------TT--------------------------TT----------------------#---------------------TT-------------g#######---------
--------------####---------##----------TT--------------------------TT------------------K---#---------------------TT-------------########--------F
--M----------#####----kk---##---gg-----TT------------gg----k-ggg---TT-----k----------------#-----gg-------K-K----TT--------k---X########--------#
XXXXXXXXXXXXXXXXXXXXXXXXXXXXXXXXXXXXXXXXXXXXXXXXXXXXXXXXXXXXXXXXXXXXXXXXXXXX---XXXXXXXXXX--XXXXXXXXXXXXXXXXXXXXXXXXXXXXXXXXXXXXXXXXXXXXXXXXXXXXXX
XXXXXXXXXXXXXXXXXXXXXXXXXXXXXXXXXXXXXXXXXXXXXXXXXXXXXXXXXXXXXXXXXXXXXXXXXXXX---XXXXXXXXXX--XXXXXXXXXXXXXXXXXXXXXXXXXXXXXXXXXXXXXXXXXXXXXXXXXXXXXX
