-----------------------------------------------------------
-----------------------------------------------------------
-----------------------------------------------------------
-----------------------------------------------------------
------------------------------------------------XX---------
------------------------------------------------XX---------
---------------------LSSS-------------------C---XX---------
------------------------------------------------XX---------
-----------------g------------------------------XX---------
-----------------#------------------------------XX---------
--------SUS-----##---2-----#---------------SS---XX---------
---------------###---------#------TT------------XX---------
--------------####---------##-----TT------------XX--------F
--M----------#####----kk---##-----TT--------k---XX--------X
XXXXXXXXXXXXXXXXXXXXXXXXXXXXXXXXXXXXXXXXXXXXXXXXXXXXXXXXXXX
XXXXXXXXXXXXXXXXXXXXXXXXXXXXXXXXXXXXXXXXXXXXXXXXXXXXXXXXXXX
