------------------------------------------------------------------------------------------------------------------------------------------------------------------------------------------------------------------------------------------------------------------------------------------------------------------------------------------
------------------------------------------------------------------------------------------------------------------------------------------------------------------------------------------------------------------------------------------------------------------------------------------------------------------------------------------
------------------------------------------------------------------------------------------------------------------------------------------------------------------------------------------------------------------------------------------------------------------------------------------------------------------------------------------
------------------------------------------------------------------------------------------------------------------------------------------------------------------------------------------------------------------------------------------------------------------------------------------------------------------------------------------
------------------------------------------------------------------------------------------------------------------------------------------------------------------------------------------------------------------------------------------------------------------------------------------------------------------------------------------
--------------------------------------------------------------g----------------------------------------------------------------------------------------------------------------------------------------------K-----------------------------------------------------------------------------------------------------------------##---------
------------------SCS-----------------------------------------SSSSS--------------------------------------------------------------------------------------------------------------------------------------SSSSSS----1------------------------------------------------------------------------------------------------------K----##---------
---------------------------TT--------------------------------------------------------------------------------------------------------------------------------------------------------------------------------------------------------------------------------------------------------------------------------------------------##---------
---------------------------TT----------------------------TT-----------------------------------------------------------------------------------------------------------------------------------------------------------------------------------------------------------------------------------------------g#----------------#--##---------
---------------------------XX----------------------TT----TT-----------------------------------------------------------------------------------------------------------------------------------------------K-----------------------------------------------------------------------------------K-----------##----------------#--##---------
-----SSS------TT---2---TT----------------TT---SU---TT----XX----------T----------------------------------------------------------------------------------------------------------------------------------SSSSSSS--------------------------------------------------------------TT---------K---------------g###----B---------#-#--##---------
--------------TT-------TT-------------K--TT--------TT----------------TT----K--------------------TT-----TT----K------------------------------TT-----TT----K------------------------------TT-----TT------------------TT--------------TT----------------------------------------TT-----TT-----K----B-------####----b--------##-#--##--------F
--------------TT-------TT-----TTTT-------TT--------TT---------TT-----TT-------------------------TT-----TT-----------------------------------TT-----TT-----------------------------------TT-----TT------------------TT---------B----TT----TT-----B-----TT----K----TT----------TT-----TT----------b------#####-y--B-------###-#--##--------#
--M-----------TT----k--TT-----TTTT-------TT------k-TT---------TT-----TT-----------ggg---------kkTT-----TT-----------ggg-------ggg---------kkTT-----TT-----------ggg-------ggg---------kkTT-----TT------------------TT---------b----TT-k--TT-----b-----TT---------TT--------XXXXXXXXXXXXXXXXXXXX-X---XXXXXXXXXXXXXXXXXXXXXXX-X--XXXXXXXXXXX
XXXXXXXXXXXXXXXXXXXXXXXXXXXXXXXXXXXXXXXXXXXXXXXXXXXXXXXXXXXXXXXXXXXXXXXXXXXXXXXXXXXXXXXXXXXXXXXXXXXXX--XXXXXXXXXXXXXXXXXXXXXXXXXXXXXXXXXXXXXXXXXX--XXXXXXXXXXXXXXXXXXXXXXXXXXXXXXXXXXXXXXXXXX--XXXXXXXXXXXXXXXXXXXXXXXXXXXXXXXXXXXXXXXXXXXXXXXXXXXXXXXXXXXXXX-XXXXX-X------XXXXXXXXXXXXXXXXXXXX-X---XXXXXXXXXXXXXXXXXXXXXXX-X--XXXXXXXXXXX
XXXXXXXXXXXXXXXXXXXXXXXXXXXXXXXXXXXXXXXXXXXXXXXXXXXXXXXXXXXXXXXXXXXXXXXXXXXXXXXXXXXXXXXXXXXXXXXXXXXXX--XXXXXXXXXXXXXXXXXXXXXXXXXXXXXXXXXXXXXXXXXX--XXXXXXXXXXXXXXXXXXXXXXXXXXXXXXXXXXXXXXXXXX--XXXXXXXXXXXXXXXXXXXXXXXXXXXXXXXXXXXXXXXXXXXXXXXXXXXXXXXXXXXXXX-XXXXX-X---------------------------------------------------------------------
