----------------------------------------------------------------------------------------------------------------------------------------------------------------------------------------------------------------------------------------------------------------------------------------------------------------------------------------------------------------------------------------------------------------
----------------------------------------------------------------------------------------------------------------------------------------------------------------------------------------------------------------------------------------------------------------------------------------------------------------------------------------------------------------------------------------------------------------
----------------------------------------------------------------------------------------------------------------------------------------------------------------------------------------------------------------------------------------------------------------------------------------------------------------------------------------------------------------------------------------------------------------
---------------------------------------------------------U------------------------------------------------------------------------------------------------------------------------------------------------------------------------------------------------------------------------------------------------------------------------------------------------------------------------------------------------------
----------------------------------------------------------------------------------------------------------------------------------------------------------------------------------------------------------------------------------------------------------------------------------------------------------------------------------------------------------------------------------------------------------------
------------------------------------------------------------------------------ooo---------------------------------------------------------------------------------------------------------------------------------------------------------g---------------------------------------------------------------------------------------------------------------------------------------------------------------------
---------------------LSSS---------------SSSSS-------------------------------------------------------------------------------------------------------------------U----------------------------------SSCCCCCCCCCCCCCCCCSCCCCCCCCCCCCCCCCCCCCSSS---SSCSSS----------------------------------------------------------------------------------------------------------------------------------------------------------
-----------------------------------------------------------SS---------------------------------------------------------------@---------------------------------------------------------------------------------------------------------------K-------------------------------------------------------------------------------------------------------------------------------------------------------------------
-----------------g----------------------------------------------#---------B-------------------------------------------------------------------------------------------------------------------------------------------------------------------------------------------------------------------------------------------------------------------------------------------------------------------------------------
-----------------#-----------------------K-------------SS------##-------y-b--------------------------------------------------------------------------------------1--------------------1-------------------------------------------------------------------------------------SSUSSSSS-----------------------------S-oo---------------------tt----------------------------------------------g#--------------------
--------SUS-----##---2-----#-------------SSSS-----------------###-------####-------------------------------------------ooo-----------------------------------TT-----------T-------tt-----------------@SSSSSSSSSSSSSSSSSSSSSSSSSSSSSSSSSSSSSS--#C-------#------------------------------------------------------------------------------TT--tt----------------------------------------------##--------------------
---------------###---------#------T--------K---#----B--------####------##---------------------------------------------------#--------------------------------TT----TT-----TT------tt---------------------------------------------------------##-----K--#-------K------------------------------------------------------------------TT--TT--tt------------------------------------TT------g###--------------B-----
--------------####---------##-----TT-----------#----b-------#####-----###---------------------------------------------------#--------------------------------TT----TT-----TT------tt--------------------------------------------------------###--------#-----------K----------------------------------#---------------------------TT--TT--tt-------B-----TT----K----TT----------TT------####------B-----K-bK----
--M----------#####----kk---##-----TT-----------#-----------######---#####----k-----S------------gkkk-------kk----#----------#-----k----ggg------------ggg----TT---kTT------T---g--tt-----gg------------------------------------------------####--------#--------------------------------------------kk#----------------------ggg--TT--TT--tt-------b-----TT---------TT----------TT-----#####-y--B-b-------B-----
XXXXXXXXXXXXXXXXXXXXXXXXXXXXXXXXXXXXXXXXXXXXXXXXXXXXXXXXXX-XXXXXXXXXXXXXXXXXXXXXXXXX---XXXXXXXXXXXXXXXXXXXXXXXXXXXXXXXXXXXXXXXXXXXXXXXXXXXXXXXXXXXXXXXXXXXXXXXXXXXXXXXXXXXXXXXXXXXXXXXXXTTXXXXXX---XXXXXXXXXXXXXXXXXXXXXXXXXXXXXXXXXXXXXXXXXXXXXXXXXXXXXXXXX-X-XX-X-XX-XXXXXXXXXXXXXXXXX-X-X-XXXXXXXXXXXXXXXXXXX------XXXXXXXXXX-XX--XX--XXXXXXXXXXXXXXXXXXXXXXX-XXXXX-X------XXXXXXXXXXXXXXXXXXX-XXXXXXXXXXXXXX
XXXXXXXXXXXXXXXXXXXXXXXXXXXXXXXXXXXXX-XXXXXXXXXXXXXXXXXXXX-XXXXXXXXXXXXXXXXXXXXXXXXX---XXXXXXXXXXXXXXXXXXXXXXXXXXXXXXXXXXXXXXXXXXXXXXXXXXXXXXXXXXXXXXXXXXXXXXXXXXXXXXXXXXXXXXXXXXXXXXXXXTTXXXXXX---XXXXXXXXXXXXXXXXXXXXXXXXXXXXXXXXXXXXXXXXXXXXXXXXXXXXXXXXX-X-XX-X-XX-XXXXXXXXXXXXXXXXX-X-X-XXXXXXXXXXXXXXXXXXX------XXXXXXXXXX-XX--XX--XXXXXXXXXXXXXXXXXXXXXXX-XXXXX-X------XXXXXXXXXXXXXXXXXXXXXXXXXXXXXXXXXX
