-------------------------------------------------------------------
-------------------------------------------------------------------
-------------------------------------------------------------------
-------------------------------------------------------------------
--------------------------------------------------------##---------
-------------------------------------------------------###---------
------------------------------------------------------####---------
-----------------------------------------------------#####---------
----------------------------------------------------######---------
---------------------------------------------------#######---------
---------!!-------------#----------------TT-------########--------F
-----------------------y#------T------r--TT----g-#########--------#
--------------------y-###---TT-TXXXXXXXXXXXXXXXXXXXXXXXXXXXXXXXXXXX
--M----------------######---TT-TXXXXXXXXXXXXXXXXXXXXXXXXXXXXXXXXXXX
XXXXXXXXXXXXX--XXXXXXXXX----TT-------------------------------------
XXXXXXXXXXXXX--XXXXXXXXX-------------------------------------------
