----------X-------X-X#------X---X--XS-----1---X#----XU--X--S---XX----XX---X#-----%X--X-|------X--%-------------XXS------X--X%----|--X|--------X-----X-
----------X----------|--------|----------------X-----S--------XXX-----X----|-S----X---X-------X----------------X--%X------XX-----X---#------X----X----
-----*-------X----ST-X----X---X----------------X--------------X--------X---|----------X------X-----X-----X---X----XX-S-X-XX-------!--#---X--X---XX--%-
----SX------XX-%-X-X-X----X--SX-----X------------XX-----X-----------X--XS----XX--------------X-g---X-----X--XX-%-XX-X----X--------X--X---X------XS----
-----|S-XX#-X----X-X---------t------X--X----------XS-X--XX-X--------X------X-X|----------------#X-X---------X--X-X-CX-------|---SXX--X----S-----------
----X-XXXX|------------------|---------X------S----------X-XT----------X---X-------------------|X-X---X--------|-----X----X-#----X------%-------------
----X-#X--|-X----------------X-----X---------%---X--------F-X---S-X----X-X--1----X-X-----------X--X---X------X-----X-X#-X-X-#-X-------|-X%g--X%-------
------#---|-X----S-X-----g---X-----X------XoX----X---X----|-|---X-X------X-------X%X-----#-----X--X----g---%-X-X--SX--#XX-----XS---S--#-XXX-----------
----@-X-S-X--------X-----X----S-----------XXXX----X--X-S--#---------------------X-T------#-------------|---|---XS-#---#|--------X---T-#--XX-X------X--
------X---X--X-----------X-X-X-X---XX-X------X----X-------T----|----------X----|X-T------X-XX-------X--X---|--%-X#X--X|---------XX--XX|M----X---X--X--
-----%-------XX----------S-X-X-X-X-XX-X--SS--%--XX--X-----X----X-TX-------X----X--t----S-X-XX-X--------X------X-X|X--X#g----X----X--XX|X------%-XX----
-----X--S----SX----X-S-S-----#---X--------------XX--XX---XX------#X-----------X---X--XT-X-----X--X-------|----X--X----#|X--*X---------#X------|--X--S-
-----|-SX----|-X---X---X--X--|-%-------X---X---------X---X---X%--|------------X---XXXX#-#--------X--XX-----X--X--X----T#X-------X-X---|---X---X----|--
-------------X-X-------X-XX--X-------X-|X--X------------X-S--XX--#------XX-----X---XX---|----X------XX-----X%-X-------|X--XX----|-X---#---X---X----X--
XXXX--X------X--------y--X---X-----X-X--X-----Xo-----%-XX-----X--|--%X--XX--g--X--------|----X--------------X-S-#------X--XX----------|-----X----o-S--
XXXX--X---------%--XSX#-S---XX---X-XX---------XXS----X-X-X-------|--XXXS-S-X|---------X-|-------------------X---XX-------X--------%--X|-----X--X-----X
