------------#------------X---X--t---------------------XX--X-----------X--X------XX-#-----------#----XX--------X----S-X----S-S----t---S--------X------#
---------X--X--------#XX--X-------------XX----XX#----------------------------XXX------------X----------------X-X-X--X-------------Xg------X-------X-#-
----X#--X-------X----X--X--------#--#-------------------------#-----------F-X-----tg----X-------#------X#----X---X------t----X--X----X-X---X-------X--
-------------------------X---X---------------##--S--X--X#--X--t----------#----t--------X---tX-----X----X-g----------XX---X----#-----X!-X----#--------X
----------g-----------------X-X----g--------#-------------------S-----#------#----X-X---X-#------g--X-------X--XX---XX----X---XX-#----------X----X@---
--------X-#X-X-----------X---------X------------S---XX-------X-------X-X------X-X-X-X----X-X------X---------#-------------X----##--------------g----X-
----X---------X-X------------X----XX---t-#X----------X-----------X--------t--------XX-X---X-----------------X--X-----S-S---------X-------X------------
----------X---------X-#-----X-----------X--X-----------------------------#-#-----------X-#-----X-----g----#-------------X--X----X#--------------------
-------#---Xg---X---X---X--#------------------X------------X-----##---------------XX--X-------------------X-------X---------------X------X----#-X-X--X
--------X--X---------X------X#----X-g--------g-------#-----------X--X-----t------------#-!X--X-X-1-#-----------X-X-------XX------X--X------------X-#--
-----X-#---X!--#-----------X----X-----------X-----X-------------#-XX--------#----------------X-X--#--XX------U-X--X--#-X---X--------------------------
----X---------------#--------t--X--X-----------------------------------#----#----X-----------X---X-----X--X----------#--X-------------X--X---X#-------
------#-X--------g----#---S---X-----XX-X--tX-g----X------S-tX-----X---------------X--##--X----------X-----X----X-X-X----#-------XXX----------X------X-
-------X------X---------------X------X-X-X----X------------gt---S-------------------X----XXt-----------------X---X------------------------X----#--S-X-
XXXX--------X-X---S-#---X---X-----X---X--#--#-----X---X-X-------------X----#-------X--X----------X-------S-----g--------X-----X----XX-##-----X--------
XXXX-#----S-#---X----#----#--t------#------X----#----------S----------XX--------X----------------Xg-X--X----#------X-------X--XX---S----X#----X#------
