--------------------------------------------------------------------------------------------------------------------------------------------
--------------------------------------------------------------------------------------------------------------------------------------------
--------------------------------------------------------------------------------------------------------------------------------------------
---------------------SSSSSSSSSSSSSSSSSSSSSSSSSSSSSSSSSSSSSSSSSSSS-------SSSS-----SSSSSSSSSSSSSSSSSSSSSSSSSSS-----SSSSSSSSSSSSSSSSSSSSSSSSSS-
-----------------------------------------------------------------------------------------------------------------SSSSSSSSSSSSSSSS-----------
-----------------------------------------------------------------------------------------------------------------SSSSSSSSSSSSSSSS-----------
----------------SSSS----------------------------------------------------SUS--------------------------------------SSSSSSSSSSSSSSSS-----------
-------------------------------TT--------------------------------------------------------------------------------S-------------------TT-----
-------------------------------TT-----------------------------------SSS------SSS---------------------------------S-------------------TT-----
-------------------------------TT-------S--------------------------------------------------------------------------oooooooooo--------TT-----
---------!!------------------SCTTSU-------------------------TT----------SSSS-------------------TT-----------------USSSSSSSSSS----#---TT----F
-------------------------TT----TT----TT---tt-------------#--TT--##-------------------------TT--TT----------#--------------------##---TT---SS
-------------------------TT----TT----TT---tt------------##--TT--##------------------tt-----TT--TT---------##-SSS---------------###---TT---SS
--M----------------------TT---kTT---kTT--ktt---------kk-##--TT--##------------------tt----kTT--TT--------###-------------kk---####--kTT---SS
XXXXXXXXXXXXX--XXXXXXXXXXXXXXXXXXXXXXXXXXXXXXXXXXXXXXXXXXX--XX--XX------XXXX------XXXXXXXXXXXXXXX--XXXXXXXXX-----XXXXXXXXXXXXXXXXXXXXXXX--XX
XXXXXXXXXXXXX--XXXXXXXXXXXXXXXXXXXXXXXXXXXXXXXXXXXXXXXXXXX--XX--XX------XXXX------XXXXXXXXXXXXXXX--XXXXXXXXX-----XXXXXXXXXXXXXXXXXXXXXXX--XX
