---------------------------------------------------------------------------------------------
---------------------------------------------------------------------------------------------
---------------------------------------------------------------------------------------------
----------------------------------------------------------------U----------------------------
---------------------------------------------------------------------------------------------
----------------------------------------------------------------------------------k----------
-----------------------------USSSS-------------SSSSS------------------------------##---------
------------------------------------------------------------------SS-------------###---------
-----------------------------------------------------------------------#--------####---------
------------------------------------------------K-------------SS------##-------#####---------
---------!!-----------------###----------------SSSSS-----------------###------######---------
-----------------------y-#####----------TT--------K---#----B--------####-----#######---------
--------------------y-######------------TT------------#----b-------#####----########--------F
--M----------------#######--------------TT------------#----B------######---#########--------#
XXXXXXXXXXXXX--XXXXXXXXX------XXX---XXXXXXXXXXXXXXXXXXXXXXXXXXXXX-XXXXXXXXXXXXXXXXXXXXXXXXXXX
XXXXXXXXXXXXX--XXXXXXXXX------XXX---XXXXXXXXXXXXXXXXXXXXXXXXXXXXX-XXXXXXXXXXXXXXXXXXXXXXXXXXX
