---------------------------------------------------------------------------------------------------------------------------------------------------------------------------------------------------------------------------------------
---------------------------------------------------------------------------------------------------------------------------------------------------------------------------------------------------------------------------------------
---------------------------------------------------------------------------------------------------------------------------------------------------------------------------------------------------------------------------------------
-------------------K-------------------------------------------------------------------------------------------------------------------------------------------------------------------------------------------------------------------
---------------------------------------------------------------------------------------------------------------------------------------------------------------------------------------------------------------------------------------
---------------------------------------------------------------------------------------------------------------------------------------------------------------------------------------------------------------------------------------
--------------------##------------------------------------------------------------------------------------------------------------------------------------------------------------------------------------------------------##---------
-------------------###----------------S1SSSSSSSSSSSSSSSSSS-------------------------------------------------------------------------------------------------------------------------------------------------------------K----##---------
------------------####------------------------------------------------------------------------------------------------------------------------------------------------------------------------------------------------------##---------
------------------####-------------------------------------------------------------------------------B-------------------------------------------------------------------------------------------------g#----------------#--##---------
--------SUS-----#-####---!!!!----------------------------------------------------S@---------SS------S#2---------------------------------------------------------S--------------------------------------##----------------#--##---------
---------------##-####---------------------------K---------SS--------------B-------------------------------B----------------------------TT---------K--------TT-------------------------------TT------g###----B---------#-#--##---------
--------------###-####-----------------#---------------------------B-----K-bK----------B-------------------b-----TT----K----TT----------TT-----TT-----K-----TT--------TT----K----TT----------TT------####----b--------##-#--##--------F
--M----------####-####-----------------#---------------------------b-------B-----------b--y------B--y-y----b-----TT---------TT----------TT-----TT--------gggTT------k-TT---------TT----------TT---g-#####-y--B-------###-#--##--------#
XXXXXXXXXXXXXXXXXXXXXXXXXXXXXXX-XXXXXXXX-XXXX-X-XXX-XXXXXXXX--XXXX-XXXXXXXXXXXXXXXXXXXXXXXXXXXXXXXXXXXXXXXXXXXXXXXXXXXXX-XXXXX-X------XXXXXXXXXXXXXXXXXXXXXXXXXXXXXXXXXXXXXXX-XXXXX-X------XXXXXXXXXXXXXXXXXXXXXXXXXXXXX-X--XXXXXXXXXXX
XXXXXXXXXXXXXXXXXXXXXXXXXXXXXXX-XXXXXXXX-XXXX-X-XXX-XXXXXXXX--XXXX-XXXXXXXXXXXXXXXXXXXXXXXXXXXXXXXXXXXXXXXXXXXXXXXXXXXXX-XXXXX-X------XXXXXXXXXXXXXXXXXXXXXXXXXXXXXXXXXXXXXXX-XXXXX-X------XXXXXXXXXXXXXXXXXXXXXXXXXXXXX-X--XXXXXXXXXXX
