---------------------------------------------------------------------------------------------------------------------------------------------------------------------------------------------
---------------------------------------------------------------------------------------------------------------------------------------------------------------------------------------------
---------------------------------------------------------------------------------------------------------------------------------------------------------------------------------------------
---------------------------------------------------------------------------------------------------------------------------------------------------------------------------------------------
---------------------------------------------------------------------------------------------------------------------------------------------------------------------------------------------
---------------------------------------------------------------------------------------------------------------------------------------------------------------------------------------------
---------------------LSSS---------------------!!!!!-----------USSS--------SSCSS------SSSS-----------------------------USSS--------------------------------------------------------##---------
----------------------------------------------------------------------------------------------------------------------------------------------------------------------------------##---------
-----------------g--------------------------------------------------------------------------------------------------------------------------------------------------------------#-##---------
-----------------#------------------------------k-----------------------------------------------g--------------------------TT---------------------------------------------------#-##---------
--------SUS-----##---2-----#-----------TT-----@!!!!----------S-----TT---!!!!--!!!---------------TT-----------------TT------TT-------------------------------------------------#-#-##---------
---------------###---------#-----------TT--------------------------TT---------------------------TT----------g------TT--tt--TT-------------------------------TT----------------#-#-##---------
--------------####---------##----------TT--------------------------TT---------------------------TT----------TT-----TT--tt--TT-------------------------------TT---------TT---#-#-#-##--------F
--M----------#####----kk---##---gg-----TT------------gg----k-ggg---TT------------ggg------------TT----------TT--g--TT--tt--TT-----k------------k------kkk---TT---------TT---#-#-#-##--------#
XXXXXXXXXXXXXXXXXXXXXXXXXXXXXXXXXXXXXXXXXXXXXXXXXXXXXXXXXXXXXXXXXXXXXXXXXXXXXXXXXXXXX----XXXXXXXXXX---XXXXXXXXXXXXXXXXXXXXXXXXXXXXXX---XXXXXXXXXXXXXXXXXXXXXXXXXXXXXXXXXXX-X-X-X-XXXXXXXXXXXX
XXXXXXXXXXXXXXXXXXXXXXXXXXXXXXXXXXXXXXXXXXXXXXXXXXXXXXXXXXXXXXXXXXXXXXXXXXXXXXXXXXXXX----XXXXXXXXXX---XXXXXXXXXXXXXXXXXXXXXXXXXXXXXX---XXXXXXXXXXXXXXXXXXXXXXXXXXXXXXXXXXX-X-X-X-XXXXXXXXXXXX
