--------X---t-----------#-X--X--X--X-##----X--S-X-t------------#---X-X-X-X-------------!X-------XX---Xt-----X-----t------X--#X-X----------X-X-----X-XX
-------tXX-----X--X-------#-#-------#----------g----Xt----XX-------X-XX-------#X--------#-----X---#---X---X--------X-gX------X---X-------y-SX-------X-
-----------X----##t---#----X-----------S----X-t----------S----------X-X-X------X----------X-#S-XX----#--t---tX---XX---XX----------X-XXX-X-------------
--------#--#------X-X-X-X---X---X--S-------------t---S----X-------X------X---------X---XX--X-------X----XX----X-----#---X---X--X--#--X-X-#--XX---X----
-----X----X----X-#------X-----X----------XX------X-XX--X---C--------X---------X-----------S-----X-------#---X----X-----X----XX------X#---X----XX------
--------X---------------X---XX--X---#--#----XXX----------X#-------------X----X-----X-X--tX--X-----t--------X-X---#X----X-X-----X--SX-X--------Xt#----X
-------X-X-X-----------#XX-X-t--X----tt---X-t-----X---X---------S--#-#-X------------------------#----XX-------------X------t-X---------------X-#---X--
----------------t-------X--#X--#X-t-X------X-X----------#X---#-----X--XS#--------S--#------X#--------XXX-X--X---------#-#-----------------#-XX------X-
----#--X--X--X-X----XX--XX---S----------XX#--X-----X-t-----XXX--t-----------------X------X-----------X---o---X------t-X#--X---X---------X---X#--------
-------------#-----#---XX--------X---------X--#-#------X#-S------X-----X----------X--tX--------t-X-X---X----XX----------X-S--X--X-X!--X-t--tX#---X----
-----X-------#-----X---X---------X-----X-XX---------------------L-X-X--X------#------------------XX----X-t-X--X-X---t-----X--------#---XX--#X-X--#-t--
-----------X-------#-#---XX-----------X-#--t---X-X-X-------X---X--#-XX-----t-X-X-X#X-----X--X--X-----X-----X--XtX------X----X-X-X-#-t-----XX--X----X#-
--------X---X--X-X--L--------------X---X----X---X----t-----S-----X-XX----X-XX-#----X-X---X----X---X---#----X--t-----#--------X-X------X---------X-X---
----X------X-X------#--X----------------#-------X--##g----------X--X--X-XX#--------X----------X-X-----X-----X---X--X-----------X-#---------X-t--------
XXXXX----------tX--X---X--t#-----X----XX----t---tX-----X--St----X----X---------X--t--XXX---#X-------XSX-tX-X---------X-XX-----X---S-----------X--#----
XXXX---X--X--!-X##---Xt-g-----X---#-----X---#-X-----XX-#---X--#---X---X-------t----------#----#-#------XXX----X-XX-------X------X--X#-X---X----#----X-
