--------X-------------XX-----r---#-------X-------------X------X#-------@-M-X-X---XX------X-----------------X---X!---------------------X-----X-------T2
--------X-X-----------o------------------------------#----------------------------X---X-X---S-----X---X---------Ut----R------X---------X--M----X------
---------y*-X-X--X----X-X---CM-X---------------X----#-------X--------------X-----X--X---X----------X-------------X--------L--X-----X--------X-X|X-----
----M----------------------------------k-------R----Y#-tX-g----------------------------X---X--X-T---X----X----X------X-------------X-------------X----
----XXX---##-%------X----------------#--#-----------------X----S-X-------X---MX-----XXX--XM-------------------X!--------X---1-#-------%------X--------
-----@-XX----|------------------X--X--X-----------------X---X----X-----L----S-X------------X--------XgXX---------X----X---------Xy---X----#X------X---
-----C-------XX-X-XX--#-K------X----C--X---------X-----------------r-------XX---K----------X----------------X-----XX----------X------------------o----
---------!-----#---g------X----M----X---#-------X---XXSL-#---X-X-S-----#XXX--X-X-#---------S------X-----X---SX--gX------------------X----------------X
----------M-T--------X-X------XXX------#------X-S-----------XX---gX-X-----X----------------#------X------X---------|----------X----XS--X---X--X--X---g
-------------------------#-------------L-X--X---t-----X----#-#------C-#R------y------------M-----------X-X-X-----------------X------XtMXU-----XX------
---------X-------#-|-------X--------------S---X---------XXK---X-----X-g-X--------X---XX-!-----------!----------X-----------X----g-X---------X-----X---
-----X--X--X-g-X----X----------X--X-X-----------YX!-----o-X------X-----t-------------X----#S----------X-----------S------------X--XC----#----Xg----X--
--------M-X----X---------------yX--X------------------------X--X-------X-X-X#-----#----X----------------#-g--X-----X---!-----2XX----S------X-M---X----
---------X------X------X---GXXY--X---------X-------X--------------X--------X---X---S----D--X--------X---X--X---X------M-----X--X--Y-X-XXX-X-%-1-------
XXXX-X---X---#------gX---X-X------S-------#!------X------Y-------k---k--o-#r---X------------------------T-----F-----------X-------X----------X------X-
XXXX------------X--------S---X----------X---X-------#R--X---|------X---XX-----X----------t-t--XX-X-----X----X-----X---t-----X-------------X-----------
