-----------------------------------------------------------------------------------------------------------------------------------------------------------------------------------------------------------------------------------------------------------------------------------
-----------------------------------------------------------------------------------------------------------------------------------------------------------------------------------------------------------------------------------------------------------------------------------
-----------------------------------------------------------------------------------------------------------------------------------------------------------------------------------------------------------------------------------------------------------------------------------
-----------------------------------------------------------------------------------------------------------------------------------------------------------------------------------------------------------------------------------------------------------------------------------
------------------------------------------------------------------------------------------------------------------------------------------------------------------------------------------------------------------------------------------------------------------------y----------
--------------------------------------------------------------------------------g--------------------r----------------------------------------------------------------------------------------1-------USS---------------------------------------------------------------##---------
-----------------------------US--------------------------------------SSCCCCCCCCSSSS---SSSS--SSSSSSSSSSSSS-------------------------------------------------------------------------------------------------------------------------------------------------------------y###---------
----------------------------------------------------------------------------------K-----------------------------------------------------------------TT----------------------------------------------------------------------------------------------------------------####---------
----------------------------------------------------------------------------------------------------------------------------------------------------TT----------------------------------------ggg--------------------------------------------------------------------#####---------
--------------------------------------------------------1-------------------------------------------k-k----#----------------------------------------##-------------------S--------------##########---#-------------TT-----------------------------------------------######---C-----
---------!!-----------------####--SSC---------------tt-----------------@SSSSSSSSSS--#C--------------CCCCCCC#---------------------------------------------------------TT----------------##--------#---#-------------TT-------------------------#--------------------#######---------
-----------------------y-#####--------------TT------tt-----------------------------##-----------------------------------------------------#------------B---TT--------TT--------TT-----###--------#---##------------TT-------------------------#-------------------########--------F
--------------------y-######----------------TT------tt----------------------------###------------------------------------------------B----#------------b---TT-----gggTT------k-TT----####--------#---##--gg----k---TT-------------------------#----y--y----------#########--------#
--M----------------#######------------------TT------tt-----gg--------------------####----------#-----kk------------gg---------ggg----b----#----g---XXXXXXXXXXXXXXXXXXXXXXXXXXXXXXXXXXXXXX--------X---XXXXXXXXXXXXXXXXXXXXXXXXXX---XXX--XXXXXXXX--XXXXXXXXXXXXXXXXXXXXXXXXXXXXXXXXXX
XXXXXXXXXXXXX--XXXXXXXXX------XX--XXXXXXXXXXXXXXXXXXXXXXXXTTXXXXXX---XXXXXXXXXXXXXXXXXXXX------XXXXXXXXXXXXXXXXXXXXXXXXXXXXXXXXXXXXXXXXX--XXXXXX---XXXXXXXXXXXXXXXXXXXXXXXXXXXXXXXXXXXXXX--------X---XXXXXXXXXXXXXXXXXXXXXXXXXX---XXX--XXXXXXXX--XXXXXXXXXXXXXXXXXXXXXXXXXXXXXXXXXX
XXXXXXXXXXXXX--XXXXXXXXX------XX--XXXXXXXXXXXXXXXXXXXXXXXXTTXXXXXX---XXXXXXXXXXXXXXXXXXXX------XXXXXXXXXXXXXXXXXXXXXXXXXXXXXXXXXXXXXXXXX--XXXXXX-----------------------------------------------------------------------------------------------------------------------------------
