------------------------------------------------------------------------------------------------------------------------------XXXXXXXXXXXXXXXXXXX--XXX--XXXXXXXXXXXXXXXXXXXXXXXXXXXXXXXXXXXXXXXXXXXXXXXXXXXXXXXXXX-
-------------------------------------------------------------------------------------------------------------------------------------------------------------------------------------------------------------------
-------------------------------------------------------------------------------------------------------------------------------------------------------------------------------------------------------------------
-------------------------------------------------------------------------------------------------------------------------------------------------------------------------------------------------------------------
-------------------------------------------------------------------------------------------------------------------------------------------------------------------------------------------------------------------
------------------------------------------------------------------oo-----------------------------------------------------------------------------------------------------------------------------------------------
---------------------LSSS----------------------------------------SSS------------------------------------SSSSS@-----------------------------------------------------------------------------------------------------
--------------------------------------------------------------------------------------------------------------------------------------------------------------------------------------------------------##---------
-----------------g------------------------------##---------------------------------------------------------------------------------------------------S-------------------oooo--------------------------###---------
-----------------#-----------------------------###------------------SSS---------------------------------ooo-------------------------------------------------------------------------------------------####---------
--------SUS-----##---2-----#----------------#--###-------@@@@@-D----------------------------------------SSSSSS-----------g##-------------------------------------------------------------------------#####---------
---------------###---------#------TT------g##--###-----------------------------------------------TT--------------K-------###------------------------------------------------------------------------######---------
--------------####---------##-----TT------###--###-----------------------------------------------TT---------------------#####---------------------------------------------TT-----------------------#######---------
--M----------#####----kk---##-----TT---g-####--###-----------K------oo-------------ggg---------kkTT--------------------######-y----------------------#--------------------TT----------------------########--------F
XXXXXXXXXXXXXXXXXXXXXXXXXXXXXXXXXXXXXXXXXXXXX--XXXXXXXXXXXXXXXXXXXXXXXX----XXXXXXXXXXXXXXXXXXXXXXXXXXX--XXXXXXXXXXXXXXXXXXXXXXX-------k-------ggg----#-------k-----kkk----TT----k---ggg------ggg-#########--------#
XXXXXXXXXXXXXXXXXXXXXXXXXXXXXXXXXXXXXXXXXXXXX--XXXXXXXXXXXXXXXXXXXXXXXX----XXXXXXXXXXXXXXXXXXXXXXXXXXX--XXXXXXXXXXXXXXXXXXXXXXXXXXXXXXXXXXXXXXXXXX--XXX--XXXXXXXXXXXXXXXXXXXXXXXXXXXXXXXXXXXXXXXXXXXXXXXXXXXXXXXXXX
