-------------------------------------------------------------------------------------------------------------------------------------------------------------------------------------------------------------------------------------------------------------------------------------------------------------------------------------------------------
-------------------------------------------------------------------------------------------------------------------------------------------------------------------------------------------------------------------------------------------------------------------------------------------------------------------------------------------------------
-------------------------------------------------------------------------------------------------------------------------------------------------------------------------------------------------------------------------------------------------------------------------------------------------------------------------------------------------------
-------------------------------------------------------------------------------------------------------------------------------------------------------------------------------------------------------------------------------------------------------------------------------------------------------------------------------------------------------
-------------------------------------------------------------------------------------------------------------------------------------------------------------------------------------------------------------------------------------------------------------------------------------------------------------------------------------------------------
-------------------------------------------------------------------------------------------------------------------------------------------------------------------------------------------------------------------------------------------------------------------------------------------------------------------------------------------g##---------
---------------------LSSS---------------------!!!!!-----------USSS--------SSCSS------SSSS------------------------------------------------SSSSCSSS-----------------------------------------------------------------------------------------------------------------------------------------------------------------------------------------g###---------
-----------------------------------------------------------------------------------------------------------------------------------------------------------------------------------------------------------------------------------------------------------------------------------------------------------------------------------------g####---------
-----------------g-----------------------------------------------------------------------------------------------------------------------------------------------------------------------------------------------------------------------------------------------------#-----------------------------------------------------------------#####---------
-----------------#------------------------------k-----------------------------------------------g----------------------------------------------------------------------SSUSSSSS-------------------------------oo---------------------tt-------------------------------##--oo------o----o------------------------------------K--------#--######---------
--------SUS-----##---2-----#-----------TT-----@!!!!----------S-----TT---!!!!--!!!---------------TT--------------------------------------#----2----#------------------------------------------------------------------------------TT--tt------------------------------###-----------------------------------------------------###-------#######---------
---------------###---------#-----------TT--------------------------TT---------------------------TT----------g--------------TT-----------#------K--#-------K------------------------------------------------------------------TT--TT--tt-----------------------------####--------------------------------------------------------------########--------F
--------------####---------##----------TT--------------------------TT---------------------------TT----------TT-------B-----TT-----------#---------#-----------K----------------------------------#---------------------------TT--TT--tt----------------------------#####----------------------#---#--------TT------------------------#########--------#
--M----------#####----kk---##---gg-----TT------------gg----k-ggg---TT------------ggg------------TT----------TT--g----b-----TT------ggg--#---------#--------------------------------------------kk#----------------------ggg--TT--TT--tt-----k--ggg-----ggg------gg######--k-------------------#-k-#--------TT-----r----gg-----------XXXXXXXXXXXXXXXXXXX
XXXXXXXXXXXXXXXXXXXXXXXXXXXXXXXXXXXXXXXXXXXXXXXXXXXXXXXXXXXXXXXXXXXXXXXXXXXXXXXXXXXXX----XXXXXXXXXX---XXXXXXXXXXXXXXXXXXXXXXXXXXXXXXXXXXXXXXXXXXXXXXXXX-X-XX-X-XX-XXXXXXXXXXXXXXXXX-X-X-XXXXXXXXXXXXXXXXXXX------XXXXXXXXXX-XX--XX--XXXXXXXXXXXXXXXXXXXXXXXXXXXXXXXXXXXXXXXXXXXX---XX---XXXXXXXXXXXXXXXXXXXXX--XXXXXXXXXXXXX--------XXXXXXXXXXXXXXXXXXX
XXXXXXXXXXXXXXXXXXXXXXXXXXXXXXXXXXXXXXXXXXXXXXXXXXXXXXXXXXXXXXXXXXXXXXXXXXXXXXXXXXXXX----XXXXXXXXXX---XXXXXXXXXXXXXXXXXXXXXXXXXXXXXXXXXXXXXXXXXXXXXXXXX-X-XX-X-XX-XXXXXXXXXXXXXXXXX-X-X-XXXXXXXXXXXXXXXXXXX------XXXXXXXXXX-XX--XX--XXXXXXXXXXXXXXXXXXXXXXXXXXXXXXXXXXXXXXXXXXXX---XX---XXXXXXXXXXXXXXXXXXXXX--XXXXXXXXXXXXX---------------------------
