-------------------------------------------------------------------------------------------------------------------------------------------------------------------------------------------------------------------------------------------------------------------------------------------------------------------------------------------------------------
-------------------------------------------------------------------------------------------------------------------------------------------------------------------------------------------------------------------------------------------------------------------------------------------------------------------------------------------------------------
-------------------------------------------------------------------------------------------------------------------------------------------------------------------------------------------------------------------------------------------------------------------------------------------------------------------------------------------------------------
-------------------------------------------------------------------------------------------------------------------------------------------------------------------------------------------------------------------------------------------------------------------------------------------------------------------------------------------------------------
-------------------------------------------------------------------------------------------------------------------------------------------------------------------------------------------------------------------------------------------------------------------------------------------------------------------------------------------------------------
-----------------------------------------------------------------------------------------------------------------------------------------------r-----------------------------------------------------------------------------------------------------------------K-------------------------------------------------------------------------------------------
------------------------------------------------------------------------------------------------------------------------------------------SSSSSSSSS-------------------------SUS--------------------------------------------------------------------------------SSSSSSS@-------------------------------r-------------------------------------------##---------
----------------------------------------------------------------------------------------------------------------------------------------------------------------------------------------------------------------------------------------------------------T----------------------------------------SSSSS--------------CCSS-----------------------###---------
----------------------------------------------------------------------------------------------------------------------------------------------------------------------------------o----------------------------------------------------------------------TT-------------------------------------------------------------------------------------####---------
---------------------@SUSSSSS--------------SSUSSSSS--------------S--------------S-oo---------------------tt-----------------------------------k-k----#---------------------------------------------------------------------------------------g#----------TX---------K--------------------------------------------------------------------------#####---------
--------S!-----K-------------------------------------------------------------------------------------TT--tt------------------------------#----2CCCCCC#---------------------#####-------------------------------------------------K-----------##----------S-----S-SSSSSS-------------------------------------------@---------------------------######---------
-------------------------------------------------------------------------------------------------TT--TT--tt------------------------------#---------------------------------#---------#--------------T-----------TT---------K---------------g###----B----------------------#------------------SSS---------------KK----------------------------#######---------
---------------------------------------------------------------------#---------------------------TT--TT--tt------------------------------#---------------------------------#------------------------TT----------TT-----TT-----K----B-------####----b--------TT------------#------------C@------------------------------TT----------TT-------########--------F
--M-------M-----k--------------------------------------------------kk#----------------------ggg--TT--TT--tt--------ggg-----ggg------ggg--#-----kk------------gg---------k--#------------k-k---------TT----------TT-----TT--------g-b------#####-y--B--------TT------------#----yyy-------------------gg----------------TT----------TT------#########--------#
XXXXXXXXXXXXXXXXXXXXXXXXXXXXXXXXX-X-X-XXXXXXXXXXXXXXXXX-X-X-XXXXXXXXXXXXXXXXXXX------XXXXXXXXXX-XX--XX--XXXXXXXXXXXXXXXXXXXXXXXXXXXXXXXXXXXXXXXXXXXXXXXXXXXXXXXXXXXXXXXXXXXXXX----XXXXXXXXXXXXXX-XXXXX-X------XXXXXXXXXXXXXXXXXXXX-X---XXXXXXXXXXXXXXXXXXXXXXXXXXXXXXXXX--XXXXXXXXXXXXXXXX-------XXXXXXXXXXXXXXXXXXX---XX--XXXXXXXXXXXXXXXXXXXXXXXXXXXXXXXXXX
XXXXXXXXXXXXXXXXXXXXXXXXXXXXXXXXX-X-X-XXXXXXXXXXXXXXXXX-X-X-XXXXXXXXXXXXXXXXXXX------XXXXXXXXXX-XX--XX--XXXXXXXXXXXXXXXXXXXXXXXXXXXXXXXXXXXXXXXXXXXXXXXXXXXXXXXXXXXXXXXXXXXXXX-----XXXXXXXXXXXXX-XXXXX-X------XXXXXXXXXXXXXXXXXXXX-X---XXXXXXXXXXXXXXXXXXXXXXXXXXXXXXXXX--XXXXXXXXXXXXXXXX-------XXXXXXXXXXXXXXXXXXX---XX--XXXXXXXXXXXXXXXXXXXXXXXXXXXXXXXXXX
