-----------------------------------------------------------------------------------------------------------------------------------------------------------
-----------------------------------------------------------------------------------------------------------------------------------------------------------
-----------------------------------------------------------------------------------------------------------------------------------------------------------
-----------------------------------------------------------------------------------------------------------------------------------------------------------
-----------------------------------------------------------------------------------------------------------------------------------------------------------
-----------------------------------------------------------------------------------------------------------------------------------------------------------
---------------------LSSS---------------------SS!SSS@SSS--------SSC----------------------------------------------------------------------------------------
------------------------------------------------------------------------------------------------------------------oooo-------------------------------------
-----------------g---------------------------------------------------------g#------------------------------------------------------------------------------
-----------------#------------------------------K---------------SSS-------g##------------------------------------------------------------------------------
--------SUS-----##---2-----#------------------SSSSSSSSSSS-----------------###------------------------------------------------------------##----------------
---------------###---------#------B--------------------------------------####--------------------------------------TT------K-------------###---------------
--------------####---------##-----b-----TT------------------------------#####--------------------------------------TT-----------K--------####-------------F
--M----------#####----kk---##-----b-----TT------------K----------------######----------kkk------kk----------kkk----TT---------------#----#####------------X
XXXXXXXXXXXXXXXXXXXXXXXXXXXXXXXXXXXXXXXXXXXXXXXXXXXXXXXXXXXXXXX----XXXXXXXXXX--XXXXTTXXXXXXXXXXXXXXXXXXXXXXXXXXXXXXXXXXXXXXXXXXXXXXXX----XXXXXX----XXXXXXXX
XXXXXXXXXXXXXXXXXXXXXXXXXXXXXXXXXXXXXXXXXXXXXXXXXXXXXXXXXXXXXXX----XXXXXXXXXX--XXXXTTXXXXXXXXXXXXXXXXXXXXXXXXXXXXXXXXXXXXXXXXXXXXXXXX----XXXXXX----XXXXXXXX
