-------------%-------------------------XX-X--------------2----X------------------------X----------------------------S---------------------------XX----
-------------X-S-----------------------X--X--------------#-----------------------------#------------------------S-------------------------------XX----
--------------------------g-------X----------------------|-XX-------------%-----------------------------S-------X-------S----------%----------------X-
----------------C---------X-------X-----------X----------X--|------S------X----o-----------X----X-------X-----------X--------------X----X-------------
-----------X---------------------X------------X-----------------------------------X--------X----X-------X-----------T-----X--------|----X-------------
-----------X-------!-------------X------------------S------------------------------------------------X--------------------X---------------------------
------------S-----X---o----S-----X------------------S----------t---------------------------------%---X-------------------------------------------S----
------T-----------X-----S------------S-----------X-------------X--------------------X------------X-C----------o---------------------------------------
------#-!----------------------------------S-----X-------------X-------------------------X--S-------------------------------------------o------S------
----X-|-------------------------------------X---------------------o----------------------X--X--------------------------------------------------------T
----X-|--------------------------X----------X------%--------------------------X--g-----------------------------S-----------------------X-------------X
---------t---------C-------------X-----------------T---------------------!----X--X-------------------------------------------X-----X---X-------X-----X
------|X-#--------SX-------------------------------T-----------------S---X-------X--S------X-X-------------------------------|-X---X-----------X------
------XX-X-------S--------------------X-X-X--X----S#------S--X--S--------X-----------X-----X-XX--------------------------------X------S---------S-S---
XXXX-----X-------------S--------------X---X--|-----X---------X-----------o-----------X--------X----X-------S-----t------------------------------------
XXXX-----S-----S-------------------------XX--------S---X-------X----------%------------o-------------------X-----X------------------------------------
