-----------------------------------------------------------------------------------------------------------------------------------------------------------------------
-----------------------------------------------------------------------------------------------------------------------------------------------------------------------
-----------------------------------------------------------------------------------------------------------------------------------------------------------------------
-----------------------------------------------------------------------------------------------------------------------------------------------------------------------
-----------------------------------------------------------------------------------------------------------------------------------------------------------------------
------------------------------------------------------------------------------------------------------------------------------------------------------------y----------
-----------------------------US-------------------------------------------------SSSSSSS---SSS!--------------@-----------SSS----S!!S-------------------------##---------
----------------------------------------------------------------------------------------------------------------------------------------------------------y###---------
---------------------------------------------------------------------oo--------g--------------------------------------------------------------------------####---------
-----------------------------------------------------------------y---------------------------------------------------------------------------------------#####---------
---------!!-----------------####--SSC------------------ooo-------##----------S@S-------------C-----SU----!--!--!-----S----------SS------#--#------------######---C-----
-----------------------y-#####----------------------------------###--------------------------------------------------------------------##--##----------#######---------
--------------------y-######-----------------------------------####-------------------------------------------------------------------###--###--------########--------F
--M----------------#######------------------y-y---------------#####---------------------------g-g--------k-----------------gg-g-g----####--####------#########--------#
XXXXXXXXXXXXX--XXXXXXXXX------XX--XXXXXXXXXXXXXXXX--XXXXXXXXXXXXXXX---XXXXXXXXXXXXXXX---XXXXXXXXXXXXXXXXXXXXXXXXXXXXXXXXXXXXXXXXXXXXXXXXXXXXXXXXXXXXXXXXXXXXXXXXXXXXXXX
XXXXXXXXXXXXX--XXXXXXXXX------XX--XXXXXXXXXXXXXXXX--XXXXXXXXXXXXXXX---XXXXXXXXXXXXXXX---XXXXXXXXXXXXXXXXXXXXXXXXXXXXXXXXXXXXXXXXXXXXXXXXXXXXXXXXXXXXXXXXXXXXXXXXXXXXXXX
