------------------------------------------------------------------------------------------------------------------------------------------------------------------------------------------------------------------------------------------------------
------------------------------------------------------------------------------------------------------------------------------------------------------------------------------------------------------------------------------------------------------
------------------------------------------------------------------------------------------------------------------------------------------------------------------------------------------------------------------------------------------------------
-------------------------------------------------------------------------------------------------------------------------------------------------------------------------------------------------------------------------U----------------------------
------------------------------------------------------------------------------------------------------------------------------------------------------------------------------------------------------------------------------------------------------
----------------------------------------------------------------------------------------------------------------------------------------oo-------------------------------------------------------------------------------------------------k----------
-----------------------------US-----------------------------------------------SSSSS@---------------------------------------------------SSS--------------------------------------------------------------SSSSS------------------------------##---------
---------------------------------------------------------------------------------------------------------------------------------------------------------------------------------------------------------------------------SS-------------###---------
----------------------------------------------------------------------------------------------------------------------##--------------------------------------------------------------------------------------------------------#--------####---------
------------------------------------------------------oo---oo-----------------ooo------------------------------------###------------------SSS-----------------------------------------B------------------K-------------SS------##-------#####---------
---------!!-----------------####--SU------------------------------------------SSSSSS-----------g##----------------#--###-------@@@@@-D----------------------------S@---------SS------S#2----------------SSSSS-----------------###------######---------
-----------------------y-#####-----------------------------------------TT--------------K-------###------TT------g##--###----------------------------------K-B-------------------------------B--------------K---#----B--------####-----#######---------
--------------------y-######-------------#---#-------------------------TT---------------------#####-----TT------###--###------------------------------------bK----------B-------------------b-----TT-----------#----b-------#####----########--------F
--M----------------#######---------------#-k-#-----------------------kkTT--------------------######-----TT---g-####--###-----------K------oo----------------B-----------b--y------B--y-y----b-----TT-----------#----B------######---#########--------#
XXXXXXXXXXXXX--XXXXXXXXX------XX--XXXXXXXXXXXXXXXXX-----X----XXXXXXXXXXXXXXX--XXXXXXXXXXXXXXXXXXXXXXXXXXXXXXXXXXXXX--XXXXXXXXXXXXXXXXXXXXXXXX----XXXXXXXXXXXXXXXXXXXXXXXXXXXXXXXXXXXXXXXXXXXXXXXXXXXXXXXXXXXXXXXXXXXXXXXXX-XXXXXXXXXXXXXXXXXXXXXXXXXXX
XXXXXXXXXXXXX--XXXXXXXXX------XX--XXXXXXXXXXXXXXXXX-----X----XXXXXXXXXXXXXXX--XXXXXXXXXXXXXXXXXXXXXXXXXXXXXXXXXXXXX--XXXXXXXXXXXXXXXXXXXXXXXX----XXXXXXXXXXXXXXXXXXXXXXXXXXXXXXXXXXXXXXXXXXXXXXXXXXXXXXXXXXXXXXXXXXXXXXXXX-XXXXXXXXXXXXXXXXXXXXXXXXXXX
