-----------------------------------------------------------------------------------------------------------------------------------------------------------------------------------------------------
-----------------------------------------------------------------------------------------------------------------------------------------------------------------------------------------------------
-----------------------------------------------------------------------------------------------------------------------------------------------------------------------------------------------------
-----------------------------------------------------------------------------------------------------------------------------------------------------------------------------------------------------
-----------------------------------------------------------------------------------------------------------------------------------------------------------------------------------------------------
-----------------------------------------------------------------------------------------------------------------------------------------------------------------------------------------------------
---------------------LSSS---------------------!!!!!-----------USSS--------SSCSSCCSSSSS---SSS!--------------@-----------SSS----S!!S--------------------------------------------------------##---------
-----------------------------------------------------------------------------------------------------------------------------------------------------------------------------------------###---------
-----------------g----------------------------------------------------------------------------------------------------------------------------------------------------------------------####---------
-----------------#------------------------------k--------------------------------------------------------------------------------------------------------------------------------------#####---------
--------SUS-----##---2-----#-----------TT-----@!!!!----------S-----TT---!!!!--!!------------C-----SU----!--!--!-----S----------SS------#--#----------##--#------------SS!S------------######---------
---------------###---------#-----------TT--------------------------TT-----------------------------------------------------------------##--##--------###--##--------------------------#######---------
--------------####---------##----------TT--------------------------TT----------------------------------------------------------------###--###------####--###-----tt--------------tt-########--------F
--M----------#####----kk---##---gg-----TT------------gg----k-ggg---TT------------------------g-g--------k-----------------gg-g-g----####--####----#####--####----tt---------gg---tt#########--------#
XXXXXXXXXXXXXXXXXXXXXXXXXXXXXXXXXXXXXXXXXXXXXXXXXXXXXXXXXXXXXXXXXXXXXXXXXXXXXXXXXXXX---XXXXXXXXXXXXXXXXXXXXXXXXXXXXXXXXXXXXXXXXXXXXXXXXXXXXXXXXXXXXXXXX--XXXXXXXXXXXXXXXXXXXXXXXXXXXXXXXXXXXXXXXXXXXX
XXXXXXXXXXXXXXXXXXXXXXXXXXXXXXXXXXXXXXXXXXXXXXXXXXXXXXXXXXXXXXXXXXXXXXXXXXXXXXXXXXXX---XXXXXXXXXXXXXXXXXXXXXXXXXXXXXXXXXXXXXXXXXXXXXXXXXXXXXXXXXXXXXXXX--XXXXXXXXXXXXXXXXXXXXXXXXXXXXXXXXXXXXXXXXXXXX
