-------------------------------------------------------------------------------------------------------------------------------------------------------------------------------------
-------------------------------------------------------------------------------------------------------------------------------------------------------------------------------------
-------------------------------------------------------------------------------------------------------------------------------------------------------------------------------------
-------------------------------------------------------------------------------------------------------------------------------------------------------------------------------------
-------------------------------------------------------------------------------------------------------------------------------------------------------------------------------------
-------------------------------------------------------------------------------------------------------------------------------------------------------------------------------------
-----------------------------US-----------------------------------------------------y---------------------2--------------------------------------------------------------###---------
----------------------------------------------------------------------------------#SSS---------------------------------------------------------y-------------------------###---------
---------------------------------------------------------------------oo----------##------------------------------------y---------------------#SS--o-------------------y--###---------
-----------------------------------------------------------------y--------------###1--------------ooo------------------XSS-@!---------------##------------------------#--###---------
---------!!-----------------####--SSC------------------ooo-------##-------------###-----------------------2-----------XX-------------------###--SC-------------------##--###---------
-----------------------y-#####----------------------------------###-----------#-###--SSS-------TT--------------------XXX------------------####---------------------y###--###---------
--------------------y-######-----------------------------------####----------##-###------------TT-------------------XXXX-------y---------#####---SSS---------------####--###--------F
--M----------------#######------------------y-y---------------#####-------------###---------y--TT-------y--y-------XXXXX---SSSSS-----y--######--------------------#####--###--------#
XXXXXXXXXXXXX--XXXXXXXXX------XX--XXXXXXXXXXXXXXXX--XXXXXXXXXXXXXXX---XXXXXXXXXXXXXXXX---XXXXXXXXXXXXXXXXXXXXXXXXXXXXXXX-------XX-XXXXXXXXXXXX------XXXXXXXXX---XXXXXXX--XXXXXXXXXXXX
XXXXXXXXXXXXX--XXXXXXXXX------XX--XXXXXXXXXXXXXXXX--XXXXXXXXXXXXXXX---XXXXXXXXXXXXXXXX---XXXXXXXXXXXXXXXXXXXXXXXXXXXXXXX-------XX-XXXXXXXXXXXX------XXXXXXXXX---XXXXXXX--XXXXXXXXXXXX
