-------------------------------------------------------------------------------------------------------
-------------------------------------------------------------------------------------------------------
-------------------------------------------------------------------------------------------------------
-------------------------------------------------------------------------------------------------------
-------------------------------------------------------------------------------------------------------
-------------------------------------------------------------------------------------------------------
---------------------LSSS-------------------------------------------------------------------##---------
-------------------------------------------------TT----------------------------------------###---------
-----------------g-------------------------------TT---------------------------------------####---------
-----------------#--------------------------k----TT--------------------------------------#####---------
-----S---US-----##---2-----#---------------STT--CCC@------------------------------------######---------
---------------###---------#------TT--------TT-----------------------------------------#######---------
--------------####---------##-----TT--------TT-------------------TT----------TT-------########--------F
--M----------#####----kk---##-----TT--------TT-----r----------r--TT----g-----TT----#-#########--------#
XXXXXXXXXXXXXXXXXXXXXXXXXXXXXXXXXXXXXXXXXXXXXXXXXXXXX---XXXXXXXXXXXXXXXXXXXXXXXXXXXXXXXXXXXXXXXXXXXXXXX
XXXXXXXXXXXXXXXXXXXXXXXXXXXXXXXXXXXXXXXXXXXXXXXXXXXXX---XXXXXXXXXXXXXXXXXXXXXXXXXXXXXXXXXXXXXXXXXXXXXXX
