------------X--X-----X---------X----X----o--X--XX--T----X-------X-X#--X-------------------X--S---------X-X------#---|------X---%-X--------------------
------S--------T-X---------o-!-X-------X-----------#-----X-------XXXX-X--X-X---------S--------------------------t---S-----X----S-X-------gX--X--------
-----------X---X-X----X-----XX---------------------#---X-Xy-S----X-#X------X----X-------------------------------T--------oX--------------XX--X---X---y
----C--#---X---X------X-----XX----------#----------#---X-X----------------------X-----------X-------XX----------|-S----Sg----S--#--------X--S----X---X
-------X-#--------#---------------------#------K---#---------------X------X-----------------X-------XX----------|-------X-------------------#---S-X--T
--------SX--------X------------%--------X----------#tS----X--X----X-------X---Xk----X------X---------------X------------X-------X---S-------|---|-X-XS
---------X--------X------------|--------X-----X----XX----!X------XX-----------XX----#------X---X-X-------#--------S-------------X---X#XX----X-S-----X-
--------------------------S----|--------X-----X----XX-X----------X-------------X---------------X-X----X-----X--S----X--X------------X##X----X---------
-----------------X----X---|gS-%X----------X-----------X--------------XX-------------------X---------X-X-----X-----S--X-X-X-S-o-------#X---------------
-----------------------X---X-----S-X------S--#-----------------------XXS------------------X-o-------X---S---X--------X---X---X-------#----------------
-------S---------------X---X------X----------t--X----------------------X%-------------X--X---X----------------------X--------SX------#-------------S--
-------T--X------------S--S------XX----------T--X--X-------S--------------------------X--X---X-----------X--------X-----------XX----rt---X--S---------
-------X--XX-----------------X---X--X----X---TX--------------------------------K---------------------X--%XS-------X------------XX---X#----------------
-------X---X-#X-------T------X----------XX-#-#X---------------------T-----X----X-----------------------X|ST---------------------X----#----------------
XXXX-------X-XX-------|-----XX-----X--X-X--X-X-------------------%--#----X-----X--X---------------X----X|-|-------------------M----X-X----------------
XXXX---------X----S-X%X-----X------X-X-----X-X--XX--#---X--------X--#----X--------X--------X---o--X-----|-X-----------------X------X-X----------------
