-------------------------------------------------------------------------------------------------------------------------------------------------------------------------------------------------------------------------------------------------
-------------------------------------------------------------------------------------------------------------------------------------------------------------------------------------------------------------------------------------------------
-------------------------------------------------------------------------------------------------------------------------------------------------------------------------------------------------------------------------------------------------
-------------------------------------------------------------------------------------------------------------------------------------------------------------------------------------------------------------------------------------------------
-------------------------------------------------------------------------------------------------------------------------------------------------------------------------------------------------------------------------------------------------
-------------------------------------------------------------------------------------------------------------------------------g--------------------r--------------------------------------------------------------------------------------------
--------------------------------------------1-----------------------------------------------------------------------SSCCCCCCCCSSSS---SSSS--SSSSSSSSSSSSS------------------------------------------------------------------------------##---------
---------------------------------------------------------oooo----------oooo------------------------------------------------------K---------------------------------------------------------------------------------------------------###---------
-----------------g------------------------------------------------------------------------------------------------------------------------------------------------------------------------------------------------------------------####---------
-----------------#-------------------------------------------------------------------------------------1-------------------------------------------k-k----#------------------------------------------------------------------------#####---------
--------SUS-----##------------------------!!!!----------------------TT--------------TT-------------tt-----------------@SSSSSSSSSS--#C--------------CCCCCCC#-----------------------------------------------------------------------######---------
---------------###-------------------------------------#------------TT--------------TT-----TT------tt-----------------------------##---------------------------------------------------------------------------------###---------#######---------
--------------####-------------------------------------#------------TT--------------TT-----TT------tt----------------------------###--------------------------------------------------------------------------------####--------########--------F
--M----------#####-------------------------yy----------#---------y--TT---y------y---TT-----TT------tt-----gg--------------------####----------#-----kk------------gg-------------kkk-------kk---------ggg------ggg-######------#########--------#
XXXXXXXXXXXXXXXXXXXXXXXXXXXXXX----XXXXXXXXXXXXXXXXXXXXXXXXXXXXXXXXXXXXXXXXXXXXXXXXXXXXXXXXXXXXXXXXXXXXXXXTTXXXXXX---XXXXXXXXXXXXXXXXXXXX------XXXXXXXXXXXXXXXXXXXXXXXXXXXXXXXXXXXXXXXXXXXXXXXXXXXXXXXXXXXXXXXXXXXXXXXXXXXXXXXXXXXXXXXXXXXXXXXXXXX
XXXXXXXXXXXXXXXXXXXXXXXXXXXXXX----XXXXXXXXXXXXXXXXXXXXXXXXXXXXXXXXXXXXXXXXXXXXXXXXXXXXXXXXXXXXXXXXXXXXXXXTTXXXXXX---XXXXXXXXXXXXXXXXXXXX------XXXXXXXXXXXXXXXXXXXXXXXXXXXXXXXXXXXXXXXXXXXXXXXXXXXXXXXXXXXXXXXXXXXXXXXXXXXXXXXXXXXXXXXXXXXXXXXXXXX
