-----------------------------------------------------------------------------------------------------------------------------------------------------------------------------------------------------------------------------------
-----------------------------------------------------------------------------------------------------------------------------------------------------------------------------------------------------------------------------------
-----------------------------------------------------------------------------------------------------------------------------------------------------------------------------------------------------------------------------------
-----------------------------------------------------------------------------------------------------------------------------------------------------------------------------------------------------------------------------------
------------------------------------------------------------------------------------------------------------------------------------------------------------------------------------------------------------------------K----------
-----------------------------------------------------------------------------------------------------------------------------------------------------------------------------------------------------------------------------------
-----------------------------US-----------------------------------------------------y---------------------2------------------------------------------------SS-------------SSS-------------------------------------------##---------
----------------------------------------------------------------------------------#SSS---------------------------------------------------------y---------------------------------TT------------------------------------###---------
---------------------------------------------------------------------oo----------##------------------------------------y---------------------#SS--o------------------------------TT-----------------------------------####---------
-----------------------------------------------------------------y--------------###1--------------ooo------------------XSS-@!---------------##-----------------------------------TT----------------------------------#####---------
---------!!-----------------####--SSC------------------ooo-------##-------------###-----------------------2-----------XX-------------------###--SC------SSSSS---------#---SSS----XX-----TT-------TT----------------TT#####---------
-----------------------y-#####----------------------------------###-----------#-###--SSS-------TT--------------------XXX------------------####-------------------#-TT-#-----------------TT-----TTTT----TT---------#TT#####---------
--------------------y-######-----------------------------------####----------##-###------------TT-------------------XXXX-------y---------#####---SSS------------##-TT-##----------------TT---TTTTTT----TT--------##TT#####--------F
--M----------------#######------------------y-y---------------#####-------------###---------y--TT-------y--y-------XXXXX---SSSSS-----y--######-----------------###-TT-##---------k------TT---TTTTTT----TT-------###TT#####--------#
XXXXXXXXXXXXX--XXXXXXXXX------XX--XXXXXXXXXXXXXXXX--XXXXXXXXXXXXXXX---XXXXXXXXXXXXXXXX---XXXXXXXXXXXXXXXXXXXXXXXXXXXXXXX-------XX-XXXXXXXXXXXX------XX--XXXXXXXXXX-XXXXXXXXXXXXXXXXXXXXXXXXXXXXXXXXXXXXXXXXXXXXXXXXXXXXXXXXXXXXXXXX
XXXXXXXXXXXXX--XXXXXXXXX------XX--XXXXXXXXXXXXXXXX--XXXXXXXXXXXXXXX---XXXXXXXXXXXXXXXX---XXXXXXXXXXXXXXXXXXXXXXXXXXXXXXX-------XX-XXXXXXXXXXXX------XX--XXXXXXXXXX-XXXXXXXXXXXXXXXXXXXXXXXXXXXXXXXXXXXXXXXXXXXXXXXXXXXXXXXXXXXXXXXX
