---------------------------------------------------------------------------------------------------------------------------------------------------------------
---------------------------------------------------------------------------------------------------------------------------------------------------------------
---------------------------------------------------------------------------------------------------------------------------------------------------------------
---------------------------------------------------------------------------------------------------------------------------------------------------------------
---------------------------------------------------------------------------------------------------------------------------------------------------------------
-------------------------------------------------K-------------------------------------------------------------------------------------------------------------
-----------------------------US----------------SSSSSSS@-------------------------------r-------------------------r----------------------------------------------
-----------------------------------------------------------------------------------SSSSS---------------------SSSSS--------------CCSS----------------##---------
-------------------------------------------------------------------------------------------------------------------------------------------------K-###---------
----------------------------------------------------K----------------------------------------------------------------------------------------------###---------
---------!!-----------------####--SSC----------SSSSSSSS-------------------------------------------@-------------------------@--------------------#-###---------
-----------------------y-#####----------------------------#------------------SSS---------------KK------SSS---------------KK---------------------##-###---------
--------------------y-######----------------TT------------#------------C@--------------------------------------------------------TT-----------#-##-###--------F
--M----------------#######------------------TT------------#----yyy-------------------gg------------------------gg----------------TT----------##-##-###--------#
XXXXXXXXXXXXX--XXXXXXXXX------XX--XXXXXXXXXXXXXXXXXXXXXX--XXXXXXXXXXXXXXXX-------XXXXXXXXXXXXXXXXXXX-------XXXXXXXXXXXXXXXXXXX---XX--XXXXXXXXXX-XX-XXXXXXXXXXXX
XXXXXXXXXXXXX--XXXXXXXXX------XX--XXXXXXXXXXXXXXXXXXXXXX--XXXXXXXXXXXXXXXX-------XXXXXXXXXXXXXXXXXXX-------XXXXXXXXXXXXXXXXXXX---XX--XXXXXXXXXX-XX-XXXXXXXXXXXX
