------------------------------------------------------------------------------------------------------------------------------------------------------------------------------------------------
------------------------------------------------------------------------------------------------------------------------------------------------------------------------------------------------
------------------------------------------------------------------------------------------------------------------------------------------------------------------------------------------------
------------------------------------------------------------------------------------------------------------------------------------------------------------------------------------------------
-------------------------------------------------------------------------------------------------------------------------TT---------------------------------------------------------------------
-------------------------------------------------------------------------------------------------------------------------TT---------------------------------------------------------------------
-----------------------------US-------------------------------------------------------------------------------------2----##---------------------------------------------------------g##---------
--------------------------------------------------------------------------------------------------------@--------------------------------------------------------------------------g###---------
----------------------------------------------------------------------------------------------------------------------------------------------------------------------------------g####---------
---------------------------------------------------------------------------------------------------------------------2-----------------------------------------------K------------#####---------
---------!!-----------------####--SSC-------------------------------------------------------------------C--------------------------------oo---------------------------###-----#--######---------
-----------------------y-#####----------------------------------------------------------------------TT---------------------------------------#----------------------------------#######---------
--------------------y-######------------------------------------------------------------------------TT---#----tt-----------------#-----------#------TT-------------------------########--------F
--M----------------#######------------------y-y-----ggg-------------kkk-------kk----------kkk-------TTk--#----tt---r-------------#----kk-----#------TT-----r----gg------------#########--------#
XXXXXXXXXXXXX--XXXXXXXXX------XX--XXXXXXXXXXXXXXXXXXXXXXXXXXXXXXXXXXXXXXXXXXXXXXXXXXXXXXXXXXXXXXXXXXXXXXXX----XXXXXXXXX----------XXXXXXXXXXXXXXXXXXXXX--XXXXXXXXXXXXX--------XXXXXXXXXXXXXXXXXXX
XXXXXXXXXXXXX--XXXXXXXXX------XX--XXXXXXXXXXXXXXXXXXXXXXXXXXXXXXXXXXXXXXXXXXXXXXXXXXXXXXXXXXXXXXXXXXXXXXXX----XXXXXXXXX----------XXXXXXXXXXXXXXXXXXXXX--XXXXXXXXXXXXX--------XXXXXXXXXXXXXXXXXXX
