-----------------------------------------------------------------------------------------------------------------------X-------------------------------------------------------------------------------------------------------------------------------------------------
-------------------------------------------------------------------------------------------------------------------------------------------------------------------------------------------------------------------------------------------------------------------------
-------------------------------------------------------------------------------------------------------------------------------------------------------------------------------------------------------------------------------------------------------------------------
-------------------------------------------------------------------------------------------------------------------------------------------------------------------------------------------------------------------------------------------------------------------------
-------------------------------------------------------------------------------------------------------------------------------------------------------------------------------------------------------------------------------------------------------------------------
------------------------------------------------------------------oo-----------------------------------------------------------------------------------------------------------------------------------------------------------------------------------------------------
---------------------LSSS----------------------------------------SSS------------------------------------------------------------------------------------------------------------------------------------------------------------------------------------------##---------
---------------------------------------------------------------------------------------------------------------------------------------------------------------------------------------------------------SSSSSS----------------TT----------------------------###---------
-----------------g------------------------------##--------------------------------------------------------------------------------------------------------------@--------------------------------------K-----------------------TT---------------------------####---------
-----------------#-----------------------------###------------------SSS----------------------o-------------------------------------oooooo-----------------------------------------------oooo------------------------------k----TT--------------------------#####---------
--------SUS-----##---2-----#----------------#--###-------@@@@@-D--------------------------------------------------------##----------------------------------------------------oo-----------------------TT---tt------------TT--CCC@------------------------######---------
---------------###---------#------TT------g##--###-----------------------------------------------TT-----TT----K---------###---------------------------K---------------------------------K--------------TT---tt------------TT-----------------------------#######---------
--------------####---------##-----TT------###--###-----------------------------------------------TT-----TT--------------####------------------------------------#--------------------------------------TT---tt------------TT-------------------TT-------########--------F
--M----------#####----kk---##-----TT-----####--###-----------K------oo-------------ggg----bgk--kkTT-----TT--------------#####-----TT-----##----gg-----------#---#-------k-kkk----kk----------kkk-------TT---tt------------TT-----r----------r--TT----g-#########--------#
XXXXXXXXXXXXXXXXXXXXXXXXXXXXXXXXXXXXXXXXXXXXX--XXXXXXXXXXXXXXXXXXXXXXXX----XXXXXXXXXXXXXXXXXXXXXXXXXXX--XXXXXXXXXXXX----XXXXXX----TT------XXXXXXXXXXXXXXXXXXX---X--XXXXXXXXXXXXXXXXXXXXXXXXXXXXXXXXXXXXXX---XX--XXXXXXXXXXXXXXXXXXX---XXXXXXXXXXXXXXXXXXXXXXXXXXXXXXXXXXX
XXXXXXXXXXXXXXXXXXXXXXXXXXXXXXXXXXXXXXXXXXXXX--XXXXXXXXXXXXXXXXXXXXXXXX----XXXXXXXXXXXXXXXXXXXXXXXXXXX--XXXXXXXXXXXXX---XXXXXX----TT------XXXXXXXXXXXXXXXXXXX---X--XXXXXXXXXXXXXXXXXXXXXXXXXXXXXXXXXXXXXX---XX--XXXXXXXXXXXXXXXXXXX---XXXXXXXXXXXXXXXXXXXXXXXXXXXXXXXXXXX
