-------------------------------------------------------------------------
-------------------------------------------------------------------------
-------------------------------------------------------------------------
-------------------------------------------------------------------------
--------------------------------------------------------------XX---------
--------------------------------------------------------------XX---------
---------------------LSSS-----------SSSSS---@-------------C---XX---------
--------------------------------------------------------------XX---------
-----------------g--------------------------------------------XX---------
-----------------#--------------------------------------------XX---------
--------SUS-----##---2-----#------------C-!--------------SS---XX---------
---------------###---------#--------------------TT----K-------XX---------
--------------####---------##-------------------TT------------XX--------F
--M----------####-----kk---##----g-------K-K----TT--------k---XX--------X
XXXXXXXXXXXXXXXXXXXXXXXXXXXXXXXXXXXXXXXXXXXXXXXXXXXXXXXXXXXXXXXXXXXXXXXXX
XXXXXXXXXXXXXXXXXXXXXXXXXXXXXXXXXXXXXXXXXXXXXXXXXXXXXXXXXXXXXXXXXXXXXXXXX
