-------------------------------------------------------------------------------------------------------------------------------------
-------------------------------------------------------------------------------------------------------------------------------------
-------------------------------------------------------------------------------------------------------------------------------------
-------------------------------------------------------------------------------------------------------------------------------------
-------------------------------------------------------------------------------------------------------------------------------------
-------------------------------------------------K-----------------------------------------------------------------------------------
-----------------------------US----------------SSSSSSS@-------------------------------r----------------------------------------------
-----------------------------------------------------------------------------------SSSSS--------------CCSS----------------##---------
-----------------------------------------------------------------------------------------------------------------------K-###---------
----------------------------------------------------K--------------------------------------------------------------------###---------
---------!!-----------------####--SSC----------SSSSSSSS-------------------------------------------@--------------------#-###---------
-----------------------y-#####----------------------------#------------------SSS---------------KK---------------------##-###---------
--------------------y-######----------------TT------------#------------C@------------------------------TT-----------#-##-###--------F
--M----------------#######------------------TT------------#----yyy-------------------gg----------------TT----------##-##-###--------#
XXXXXXXXXXXXX--XXXXXXXXX------XX--XXXXXXXXXXXXXXXXXXXXXX--XXXXXXXXXXXXXXXX-------XXXXXXXXXXXXXXXXXXX---XX--XXXXXXXXXX-XX-XXXXXXXXXXXX
XXXXXXXXXXXXX--XXXXXXXXX------XX--XXXXXXXXXXXXXXXXXXXXXX--XXXXXXXXXXXXXXXX-------XXXXXXXXXXXXXXXXXXX---XX--XXXXXXXXXX-XX-XXXXXXXXXXXX
