---------------------------------------------------------------------------------------------------------------------------------------------------------------------------------------------------------------------------------------------------------------------------------------------------------------------------------------------------------------------------------------
---------------------------------------------------------------------------------------------------------------------------------------------------------------------------------------------------------------------------------------------------------------------------------------------------------------------------------------------------------------------------------------
---------------------------------------------------------------------------------------------------------------------------------------------------------------------------------------------------------------------------------------------------------------------------------------------------------------------------------------------------------------------------------------
---------------------------------------------------------------------------------------------------------------------------------------------------------------------------------------------------------------------------------------------------------------------------------------------------------------------------------------------------------------------------------------
--------------------------------------------------------------------------------------------------------------------------------------------------------------------------------------------------------------------------------------------------------------------oo-----------------------------g-----------------------------------------------------------------------------------
----------------------------------------------------------------------------------------------------------------------------------------------------------------------------------------------------SSSSS---@------------------------------------------------------SSS---------------------------SSSSSSSS---SSS!--------------@-----------SSS----S!!S-----------------------##---------
---------------------LSSS---------------------!!!!!-----------USSS--------SSCSS------SSSS----------------------------------------------------------------------------------------------------------------------------------------------------------------------------------------------------------------------------------------------------------------------------------###---------
----------------------------------------------------------------------------------------------------------------------------------------------S--------------------------@------------------------------------------------------------------------##--------------------------------------------g-------------------------------------------------------------------------####---------
-----------------g-------------------------------------------------------------------------------------------------------------------------------------------------------------------------------------------------------------------------------###------------------SSS------------------------------------------------------------------------------------------------#####---------
-----------------#------------------------------k-----------------------------------------------g------------------------------------------------------------------------------------------------C--------!----------------g##----------------#--###-------@@@@@-D----------------------------S@S--------------C-----SU----!--!--!-----S----------SS------#--#----------######---------
--------SUS-----##---2-----#-----------TT-----@!!!!----------S-----TT---!!!!--!!!---------------TT-----------------------------------------------------------------------C----------------#---------------------TT--------####------TT------g##--###----------------------------------K-B----------------------------------------------------------------##--##--------#######---------
---------------###---------#-----------TT--------------------------TT---------------------------TT----------g--------------------------------------------------------TT---------------K---#---------------------TT-------######-----TT------###--###------------------------------------bK--------------------------------------------------------------###--###------########--------F
--------------####---------##----------TT--------------------------TT---------------------------TT----------TT-------B------------------------#----------------------TT---#---------------#-----gg-------K-K----TT---------####-----TT---g-####--###-----------K------oo----------------B-----------------------g-g--------k-----------------gg-g-g----####--####----#########--------#
--M----------#####----kk---##---gg-----TT------------gg----k-ggg---TT------------ggg------------TT----------TT--g----b---ggg--k--------ggg----#-------k-----kk-------TTk--#---XXXXXXXXXX--XXXXXXXXXXXXXXXXXXXXXXXXXXXXXXXXXXXXXXXXXXXXXXXXXXXXX--XXXXXXXXXXXXXXXXXXXXXXXX----XXXXXXXXXXXXXXXXXXXXXXXXXX---XXXXXXXXXXXXXXXXXXXXXXXXXXXXXXXXXXXXXXXXXXXXXXXXXXXXXXXXXXXXXXXXXXXXXXXXXXXXX
XXXXXXXXXXXXXXXXXXXXXXXXXXXXXXXXXXXXXXXXXXXXXXXXXXXXXXXXXXXXXXXXXXXXXXXXXXXXXXXXXXXXX----XXXXXXXXXX---XXXXXXXXXXXXXXXXXXXXXXXXXXXXXXXXXXXXX--XXX--XXXXXXXXXXXXXXXXXXXXXXXXX---XXXXXXXXXX--XXXXXXXXXXXXXXXXXXXXXXXXXXXXXXXXXXXXXXXXXXXXXXXXXXXXX--XXXXXXXXXXXXXXXXXXXXXXXX----XXXXXXXXXXXXXXXXXXXXXXXXXX---XXXXXXXXXXXXXXXXXXXXXXXXXXXXXXXXXXXXXXXXXXXXXXXXXXXXXXXXXXXXXXXXXXXXXXXXXXXXX
XXXXXXXXXXXXXXXXXXXXXXXXXXXXXXXXXXXXXXXXXXXXXXXXXXXXXXXXXXXXXXXXXXXXXXXXXXXXXXXXXXXXX----XXXXXXXXXX---XXXXXXXXXXXXXXXXXXXXXXXXXXXXXXXXXXXXX--XXX--XXXXXXXXXXXXXXXXXXXXXXXXX------------------------------------------------------------------------------------------------------------------------------------------------------------------------------------------------------------
