------------------------------------------------------------------------------------------------
------------------------------------------------------------------------------------------------
------------------------------------------------------------------------------------------------
------------------------------------------------------------------------------------------------
----------------R-------------------oo--oo------------------------------------------------------
----------------------g----oo----------------------------R-----oo--------------------##---------
------------------%%%%%%-----------------------------r-------------------------------##---------
-------------------||||------------------------%%%%%%%%----------------------------####---------
-----oooo----------||||-----SSS-----------------||||||---------------------SSS-----####---------
------------%%%----||||--------------SS---------||||||-----%%%%--%%%%------------######---------
-------------|-----||||-------------------------||||||------||----||-------------######---------
-------------|-----||||------------------%%%%---||||||------||----||-------------######--------F
--M----------|-----||||-------------------||----||||||--ooo-||----||---------r---######--------#
%%%%%%%-%%%%-|-----||||-------------------||----||||||--%%%-||----||----XXXXXXXXXXXXXXXXXXXXXXXX
-||-||---||--|-----||||-------------------||----||||||---|--||----||----XXXXXXXXXXXXXXXXXXXXXXXX
-||---------------------------------------------------------------------------------------------
