----------------------------------------------------------------------------------------------------------------------------------------------------------------------------------------
----------------------------------------------------------------------------------------------------------------------------------------------------------------------------------------
----------------------------------------------------------------------------------------------------------------------------------------------------------------------------------------
----------------------------------------------------------------------------------------------------------------------------------------------------------------------------------------
----------------------------------------------------------------------------------------------------------------------------------------------------------------------------------------
----------------------------------------------------------------------------------------------------------------------------------------------------------------------------------------
-----------------------------US----------------------------------------------------------------------------------------------------------------------------------------------##---------
------------------------------------------------------------------------------------------S-----------------------------------------oooo------------------------------------###---------
---------------------------------------------------------------------------------------------------------------------------------------------------------------------------####---------
--------------------------------------------------------tt----------------------------------------------------------------------------------------------------------------#####---------
---------!!-----------------####--SSC---------------TT--tt---------------------------------------------------------------------------------------------------------------######---------
-----------------------y-#####------------------TT--TT--tt---------------------------------------------------------------------------TT---------------------------------#######---------
--------------------y-######--------------------TT--TT--tt--------------------------------#------------------------------------------TT--------------------------------########--------F
--M----------------#######-----------------ggg--TT--TT--tt-----k--ggg-----ggg------ggg----#-------k-----kkk-------kk----------kkk----TT----k---ggg-------ggg------ggg-#########--------#
XXXXXXXXXXXXX--XXXXXXXXX------XX--XXXXXXXXXXXX-XX--XX--XXXXXXXXXXXXXXXXXXXXXXXXXXXXXXXX--XXX--XXXXXXXXXXXXXXXXXXXXXXXXXXXXXXXXXXXXXXXXXXXXXXXXXXXXXXXXXXXXXXXXXXXXXXXXXXXXXXXXXXXXXXXXXX
XXXXXXXXXXXXX--XXXXXXXXX------XX--XXXXXXXXXXXX-XX--XX--XXXXXXXXXXXXXXXXXXXXXXXXXXXXXXXX--XXX--XXXXXXXXXXXXXXXXXXXXXXXXXXXXXXXXXXXXXXXXXXXXXXXXXXXXXXXXXXXXXXXXXXXXXXXXXXXXXXXXXXXXXXXXXX
