-------------------------------------------------------------------------------------------------------------------------------------------------------------------------------------------------------------------------------------------------------------------------------------------------------------------------------
-------------------------------------------------------------------------------------------------------------------------------------------------------------------------------------------------------------------------------------------------------------------------------------------------------------------------------
-------------------------------------------------------------------------------------------------------------------------------------------------------------------------------------------------------------------------------------------------------------------------------------------------------------------------------
--------------------------------------------------------------------------------------------------------------------------------------------------------------------------------------------------------------------------------------------------------TT---------------------------------------------------------------------
--------------------------------------------------------------------------------------------------------------------------------------------------------------------------------------------------------------------------------------------------------TT---------------------------------------------------------------------
---------------------------------------------------------------------------------------------------------------------------------------------------------------------------------------------------------------------------------------------------2----##---------------------------------------------------------------------
------------------SCSSSCSSS------------------------------------------------------------------------------------------------------------------------------------------------------------------------------------------------------------@---------------------------------------------------------------------------g##---------
--------------------------------------------------------------------------------------------------------------------------------------------------------------------------------------------@---------------------------------------------------------------------------------------------------------------------g###---------
--------------------------------------------------------------------------------------------------------------------------------------------------------------------------oooo--------------------------------------oooo----------------------------2------------------------------------------------------------g####---------
----------------------------------------------------------------------------oooo-------------------------------------------oooo--------------------------------------------------------------------------ooo---------------------------C------------------------------------------------------------K------------#####---------
-----SSS------TT---2---2----#-------------------##--#---------------------------------------------##---------------------------------------------##-------------TT----------------K------------------------------------------------TT-----------------------------------oo---------------------------###-----#--######---------
--------------TT---------K--#-------K--K-------###--##------------TT----------------K-------------###------------TT----------------K-------------###-------#----TT--------------------------#--------------------------------------TT---#----tt-----------------------------#----------------------------------#######---------
--------------TT------------#-----------------####--###------#----TT---------------------K--------####------#----TT---------------------K--------####------##---TT------kk--------------#---#-------k-kkk----kk----------kkk-------TTk--#----tt---r-------------#-----------#------TT-------------------------########--------F
--M-----------TT------------#----------------#####--####-----##---TT------kk-----------------#----#####-----##---TT------kk-----------------#----#####-----XXX--TTXXXXXXXXXXXXXXXXXXXXXXX---X--XXXXXXXXXXXXXXXXXXXXXXXXXXXXXXXXXXXXXXXXXX----XXXXXXXXX----------#----kk-----#------TT-----r----gg------------#########--------#
XXXXXXXXXXXXXXXXXXXXXXXXXXXXXXXXX-X-XX-XXXXXXXXXXX--XXXXX----XXX--TTXXXXXXXXXXXXXXXXXXXXXXXXXX----XXXXXX----XXX--TTXXXXXXXXXXXXXXXXXXXXXXXXXX----XXXXXX----XXX--TTXXXXXXXXXXXXXXXXXXXXXXX---X--XXXXXXXXXXXXXXXXXXXXXXXXXXXXXXXXXXXXXXXXXX----XXXXXXXXX----------XXXXXXXXXXXXXXXXXXXXX--XXXXXXXXXXXXX--------XXXXXXXXXXXXXXXXXXX
XXXXXXXXXXXXXXXXXXXXXXXXXXXXXXXXX-X-XX-XXXXXXXXXXX--XXXXX----XXX--TTXXXXXXXXXXXXXXXXXXXXXXXXXX----XXXXXX----XXX--TTXXXXXXXXXXXXXXXXXXXXXXXXXX----XXXXXX---------------------------------------------------------------------------------------------------------XXXXXXXXXXXXXXXXXXXXX--XXXXXXXXXXXXX--------XXXXXXXXXXXXXXXXXXX
