--------------------------------------------------------------------------
--------------------------------------------------------------------------
--------------------------------------------------------------------------
--------------------------------------------------------------------------
----------------------------------------------------------------k---------
---------------------------------------------------------------k----------
---------------------LSSS--------------------------------------k#---------
------k----------------------------k----------------------k---###---------
-----------------g-------------------------------------------####---------
-----------------#------------------------------------------#####---------
-----S--SUS-----##---2-----#----------------S!S------------######---------
---------------###---------#----------------------------k-#######---------
--------------####---------##-------------C-----------tt-########--------k
--M----------#####----kk---##---y--k--g----------gg---tt#########k-------#
XXXXXXXXXXXXXXXXXXXXXXXXXXXXXXXXXXXXXXXXXXXXXXXXXXXXXXXXXXXXXXXXXXXXXXXXXX
XXXXXXXXXXXXXXXXXXXXXXXXXXXXXXXXXXXXXXXXXXXXXXXXXXXXXXXXXXXXXXXXXXXXXXXXXX
