----r-------------------------rXXXXXXXXXXXXX--XXXXX--#####---XXXXXXXXXXXXX--XX------------------------------------------------------XXXXXXXXXX-------------------#----------------------r------------o--------------------------rb--rXXXXXXXXrr--rr--r-r--r--XXXXXXXXX---####--XXX--------------------------------------r-*-r-----r-r---------------------r----r----r-----------------r----------S--------------
--------------------------------rXXXXXXXXXXX--XXXXXr-XXXXXX--XXXXXXXXXXXXX--X---------------------------------------r-----------------------------X----tt--------#-XXXXXrr------------------------------------------------XXXXXX-XXXXXXXXXXXXXXXXXXXXXXXXXXXXXXXXXXXXX---XXXX--XXX-r---------------K--K-rr----r-r----gg-XXX---XXXXXXXXXXXXXXXXr-------r--------#---r---rr-----------------------r---------------
-----------------------------------------------------XXXXXX------------------------------------------------------r----------------g---------------Xr---tt--rr----XXXXXXX---B------K--------2--------------------------B-XXXXXXXX-XXXX-------rXXXXXXXXXXXXXXXX------------XXXX-------r----rr--rr---------XX-XXXXXXXXXXXXXXXX---XXXXXXXXXXXXXXXX------rrr--r--XXXXXXXXXXXXX--------------------B------------------
---------S------------------r--------r--------------------------------------------------r-----------r-------r--------r---------r-!S--------------------XXXXXXXXX-XX--------b---------------------------###-------#----b-XX----------------------------------------------------------------------r------XXX-XXXXXXXXXXXXX----------------------r--XXXXXXXXXXXXXXXXXXXXXXXXr-XXXr-----r-r------b------------------
--------r------------r------------r-----r-----------------------------------------r--------S--2------!SSS-SSS-----------------rrS----------------------XXXXXXXXX----------XB-------r--------------------XXX--XXXXXXXX-X--------------------------------------r------------------------XXXXXXXXXXXXXXXXXX--r--------------------------------------XXXXXXXXXXX---------------XXX--XXXXXXXXXXXXXXXXXX-----------r--
-----------r-----------r------r-------------rr--------------------------------r----r-------------------------------------r-----S---r--------------------------------r-----XXX-rXXXXXrr------------------XXX--XXXXXXXX-X----------r----------------------------------------------------XXXXXXXXXXXXXXXXX---r---------------------------------------------------------------------XXXXXXXXXXXXXXXXXXX-------------
----------------------------r------------------------------------------------r------------------------------------r----------------r---------------------------------------XXXXXXXXX---r-r------------------------------r------------------------------------------------r---r---------------------------------r----------------------------------------------------------------------------------X---XXXr------
-------------------------------------------------------------------------------------------r---------r---------------------------@S---------2-------r------------------------XX--------XXXXXX-----------------------------------r----rr----------------------r-------------------r-------------------------------------------r------------------------------------------------------------------------XXXr---rrr
--------S---SSS---r------------!--------2-----------r--------r-----------------------------r----------!CS@SSr-------------------r----------------------r-----------r-------------------XXXXXX-----------------------------r-r-----------------r-------------------------------r-------r---------------------------------r--r----------r-----------------------r---------------------------------------------XXXX
--------------------------------------------------------------r----------------------------------------------r------------------------r----------------------------------------r---------r------------------r--------r----rS-!-------r---------r-------2----2---o-r---------------r-----r-------------------r-----r----r---r---r-------------rr----------------------r--------------------------------------XXXX
----------------------------------------------------------------------------------------------------r-----------------r--ggg-----r-----------2r----r-------------r-SSSSSS----r------r--------------------------------------------------------------------------------------------r---------------------r------------------------r---------------r-----------r----SSS---------r---------------------r--r---------
-------------------------B---------------o--------------------------------------------------r---r--gg----r---XXXXX--XXXXXXXXXXX-XXX------------------SSS------2------------------------------------------------------------------------------------------------------------------------r-------r-----------------------------------------------r----------------S------------r--r--------------r---------r------
----r----------r---r-----b-------------------------------------K-----------------------ggXXXXXXXXXXXXXXXXXXXXXXXXX--XXXXXXXXXXX-XXX----------------------r---------------------------------------r-------------------------------------------r---------------o-------------------TCU-r-------------r------------------------#-----------------------------------r-------------r-------2-------------rr---r------
--M-r-----------------r--b---------------------TT-----##-------------------------rrXXXXXXXXXXXXXXXXXXXXXXXXXX----------------------r-----r----------S-------------------------------r-----------TT--------------------------!S---------------T-----------------TT------------#---T-------r---------------------------------S---------------------------------------K-----------------------------!--------------
XXXXX---XX------XXXXXXXXXXXXX-X----------------TT-----###---------------------KXXXXXXXXXX------------------------------------------------r-r---r---------------2--#-----------r-----------------TT-----------r------------------------r------T-----------------TT-----------##---T---r---------------------------------------------------------------------------#SS------------------------------T-------------
XXXXX---XX------XXXXXXXXXXXXX-X-X-----rr-------TT-----####-----g-------ggg----XXXXX----------------------------------------------r---XXXXXXXXXX-r-----------------#------------------------2----##SS---o------------------------r-B----r--r--T-----------------TTr----#---####---T----------------------------------------------------------r-------------------r----------------------K----------b----------r--
