----------------------------------------------------------------------------------------------------------------------------------------------------------------------------------------------------------------------------------------------------------------------------------------------------------------------------------------------------------------------------------------------------------------
----------------------------------------------------------------------------------------------------------------------------------------------------------------------------------------------------------------------------------------------------------------------------------------------------------------------------------------------------------------------------------------------------------------
----------------------------------------------------------------------------------------------------------------------------------------------------------------------------------------------------------------------------------------------------------------------------------------------------------------------------------------------------------------------------------------------------------------
-------------------------------------------------------------------------------------------------------------------------------------------------------------------------------------------------------------------------------------------------------------------------------g-----------------------------------------------------------------------------------------------------------------g--------------
------------------------------------------------------------g---------------------------------------------------------------------------------------------------------------------------------------------------------------------------------------------------------------------------------------------------------------------------------------------------------------------------------------------------
----------------------g---------------------------g-------------------------------------------------------------------------------------------------------------------------------g-------------------------oo--------------------------------------------------------------g-------------------------------------------------------------------------g---------------------gg----------------------------------
---------------------LSSS-----------------------SSSSCSSS-----------------------------------------------------------------------------------------------------------g---------------------------------------SSS------k----------------------------------------------------------------------------------------------------------------------------------S-----------------------------------------------------g--
------------------g---------------------------------------------------------------------------------------------------------------------------------------------------------------------------------------------g----------------------------------------------------------------------------------------------------------g--------------------------------------------------------@---------------------------
----------g------g------------------------------------------------------------------------------------------------------------------------------------------------------------------------##-------------------g--------------------------------------------------------------------------------------------------------------------------------------------------@---------------------------------------------
-----------------#------------------------------------------------------------SSUSSSSS---------------SUSSSSS-------------------g---o--------------------------------------------------g--###------------------SSS-------------------------------------------------oo---------------------tt---------------------------------------------------------------------------------------------------------------------
---------US-----##---2-----#-------------------#----2----#---------------------------------------------------------------------TT--------TT-------TT---------------g##----------@-----#--###-------@@@@@-D---------------------------------------------------------------------------TT--tt-----------------------------------------------------K------------------------------ooo------------------------------
---------------###---------#------TT-----------#------K--#-------K-------------------------------------------------------------TT--------TT-----TTTT----TT---------###------TT------g##--###---------------------------------------------#---------------------------------------gT--TT--tt-------------------------g----------TT---------------------------------------------------#------------------------TT-
--------------####---------##-----TT-----------#---------g-----------K---------------------------------------------------------TT--------TT---TTTTTT----TT--------#####-----TT-----g###--###----------------------------------------B----#-----------#---------------------------TT--TT--tt-------B-----TT---------TT----------TT-----TT-----K----B---------------#----------------g#------------------------TT-
--M----------#####----kk---##---g-TT--gg--ggg--g--kg-----#-----------------------------------------k---g-----------------g-----gT--------TT---ggTTTT-----T-------k#####-----TT---g-####--###-----------K------og-------------ggg---g-----#----ggg--k-------k-------g--------ggg--TT--TT--tg-------b-----TT---------TT----------TT---g-TT-k------ggb-----g-----#---#-------k-kkk--g-k#---k-k----ggg---g--g--kkTT-
XXXXXXXXXXXXXXXXXXXXXXXXXXXXXXXXXXXXXXXXXXXXXXXXXXXXXXXXXXXXXX-X-XX-X-XX-XXXXXXXXXXXXXXXXX-X-X-XXXXXXXXXXXXXXXXX-X-X-XXXXXXXXXXXXXXXXXXXXXXXXXXXXXXXXXXXXXXXXXXXXXXXXXXXXXXXXXXXXXXXXXX--XXXXXXXXXXXXXXXXXXXXXXXX----XXXXXXXXXXXXXXXXXX--XXXXXXXXXXXXXXXXXXXXXX------XXXXXXXXXX-XX--XX--XXXXXXXXXXXXXXXXXXXXXXX-XXXXX-X------XXXXXXXXXXXXXXXXXXXX-X---XXXXXXXXX---X--XXXXXXXXXXXXXXXXXXXXXXXXXXXXXXXXXXXXXXXXXXX
XXXXXXXXXXXXXXXXXXXXXXXXXXXXXXXXXXXXXXXXXXXXXXXXXXXXXXXXXXXXXX-X-XX-X-XX-XXXXXXXXXXXXXXXXX-X-X-XXXXXXXXXXXXXXXXX-X-X-XXXXXXXXXXXXXXXXXXXXXXXXXXXXXXXXXXXXXXXXXXXXXXXXXXXXXXXXXXXXXXXXXX--XXXXXXXXXXXXXXXXXXXXXXXX----XXXXXXXXXXXXXXXXXX---XXXXXXXXXXXXXXXXXXXXX------XXXXXXXXXX-XX--XX--XXXXXXXXXXXXXXXXXXXXXXX-XXXXX-X------XXXXXXXXXXXXXXXXXXXX-X---XXXXXXXXXX--X--XXXXXXXXXXXXXXXXXXXXXXXXXXXXXXXXXXXXXXXXXXX
