-----------------------------------------------------------------------------------------------------------------------------------------------------------------------
-----------------------------------------------------------------------------------------------------------------------------------------------------------------------
-----------------------------------------------------------------------------------------------------------------------------------------------------------------------
-----------------------------------------------------------------------------------------------------------------------------------------------------------------------
------------------------------------------------------------------------------------------------------------------------------------------------------------K----------
----------------------------------------------------------------------------------g------------------------------------------------------------------------------------
-----------------------------US-------------------------------------------------SSSSSSSS---SSS!--------------@-----------SSS----S!!S------------------------##---------
-----------------------------------------------------------------------------------------------------------------------------------------------------------###---------
---------------------------------------------------------------------oo--------g--------------------------------------------------------------------------####---------
-----------------------------------------------------------------y---------------------------------------------------------------------------------------#####---------
---------!!-----------------####--SSC------------------ooo-------##----------S@S--------------C-----SU----!--!--!-----S----------SS------#--#----------TT#####---------
-----------------------y-#####----------------------------------###---------------------------------------------------------------------##--##--------#TT#####---------
--------------------y-######-----------------------------------####--------------------------------------------------------------------###--###------##TT#####--------F
--M----------------#######------------------y-y---------------#####----------------------------g-g--------k-----------------gg-g-g----####--####----###TT#####--------#
XXXXXXXXXXXXX--XXXXXXXXX------XX--XXXXXXXXXXXXXXXX--XXXXXXXXXXXXXXX---XXXXXXXXXXXXXXXX---XXXXXXXXXXXXXXXXXXXXXXXXXXXXXXXXXXXXXXXXXXXXXXXXXXXXXXXXXXXXXXXXXXXXXXXXXXXXXX
XXXXXXXXXXXXX--XXXXXXXXX------XX--XXXXXXXXXXXXXXXX--XXXXXXXXXXXXXXX---XXXXXXXXXXXXXXXX---XXXXXXXXXXXXXXXXXXXXXXXXXXXXXXXXXXXXXXXXXXXXXXXXXXXXXXXXXXXXXXXXXXXXXXXXXXXXXX
