----------------------------------------------------------------------------------------------------------------------------------------------XXXX-----------------------------------------------------------------------------------------------------------------------------------------------------------------------------------------------------------------------------------------------------------------
-------------------------------------------------------------------------------------------------------------------------------------------------------------------------------------------------------------------------------------------------------------------------------------------------------------------------------------------------------------------------------------------------------------------
-------------------------------------------------------------------------------------------------------------------------------------------------------------------------------------------------------------------------------------------------------------------------------------------------------------------------------------------------------------------------------------------------------------------
------------------------------------------------------------------------------------------------------------------------------------------------------------------------------------k---------------------------------------------------------------------------------------------------------g--------------------------------------------------------------------------------------------------------------------
-------------------------------------------------------------------------------------------------------------------------------------------------------------------------------S---SSSSSSSSS------------US---SS-------------SSS-------------------------------------------------------------SSSSSSSS---SSS!--------------@-----------SSS----S!!S--------------------------------------------------------##---------
-----------------------------------------------------------------------------------------K---------------------------------------------------------------------------------TT------------------------------------------------------TT------------------------------------------------------------------------------------------------------------------------------------------------------------------###---------
---------------------LSSS---------------------!!!!!------------SSSSS---@-------------SSSSSS----1---------------------------------------------------------------------------TT------------------------------------------------------TT------------------------------------------------------g----------------------------------------------------------------------------------------------------------####---------
---------------------------------------------------------------------------------------------------------------------------------------------------------------------------TT-------------------------SS---------------------------TT---------------------------------------1------------------------------------------------------------------------------------------------------------------------#####---------
-----------------g------------------------------------------------------------------------------------------------------------------------------------------------tt------SXXS------------------------------SSS---------#---SSS----XX---------------------tt---------tt------------------S@S--------------C-----SU----!--!--!-----S----------SS------#--#----------##--#------------SS!S------------######---------
-----------------#------------------------------k-------------------------------------K-------------------------------------------------------------------TT------tt-----------------------------------------------#-TT-#-------------------------tt------tt---------tt-----------------------------------------------------------------------------##--##--------###--##--------------------------#######---------
--------SUS-----##---2-----#-----------TT-----@!!!!---------C--------!--------------SSSSSSS--------------------------------------------------------T------TT------tt-TT--------TT--------------TT--TT-------------##-TT-##----------------B-------tt------tt---------tt----------------------------------------------------------------------------###--###------####--###-----tt--------------tt-########--------F
---------------###---------#-----------TT----------------------------------TT------------------TT--------------TT----------------------------------T----k-TT------tt-TT--------TT--------------TT--TT------------###-TT-##---------k------b-------tt-g----tt-----g-g-tt------------------------------------g-g--------k-----------------gg-g-g----####--####----#####--####----tt---------gg---tt#########--------#
--------------####---------##----------TT----------------------------------TT------------------TT---------B----TT----TT-----B-----TT----K----TT---TT-XXXXXXXXXXXXXXXXXXXXXXXXXXXXXXXXXX------XXXXXXXXXXXX-X-XXXXXXXX-XXXXXXXXXXXXXXXXXXXXXXXXXXXXXXXXXXXXXXXXXXXXXXXXXXXXXXXXXXXX--XXXXXXXXXXXXXXX---XXXXXXXXXXXXXXXXXXXXXXXXXXXXXXXXXXXXXXXXXXXXXXXXXXXXXXXXXXXXXXXX--XXXXXXXXXXXXXXXXXXXXXXXXXXXXXXXXXXXXXXXXXXXX
--M----------#####----kk---##---gg-----TT------------gg----gg-------K-K----TT------------------TT---------b----TT-k--TT-----b-----TT---------TT-TTTT-XXXXXXXXXXXXXXXXXXXXXXXXXXXXXXXXXX------XXXXXXXXXXXX-X-XXXXXXXX-XXXXXXXXXXXXXXXXXXXXXXXXXXXXXXXXXXXXXXXXXXXXXXXXXXXXXXXXXXXX--XXXXXXXXXXXXXXX---XXXXXXXXXXXXXXXXXXXXXXXXXXXXXXXXXXXXXXXXXXXXXXXXXXXXXXXXXXXXXXXX--XXXXXXXXXXXXXXXXXXXXXXXXXXXXXXXXXXXXXXXXXXXX
XXXXXXXXXXXXXXXXXXXXXXXXXXXXXXXXXXXXXXXXXXXXXXXXXXXXXXXXXXXXXXXXXXXXXXXXXXXXXXXXXXXXXXXXXXXXXXXXXXXXXXXXXXXXXXXXXXXXXXXXXXXXXXXXXXXXXXXXX-XXXXX-TTTT---------------------------------------------------------------------------------------------------------------------------------------------------------------------------------------------------------------------------------------------------------------
XXXXXXXXXXXXXXXXXXXXXXXXXXXXXXXXXXXXXXXXXXXXXXXXXXXXXXXXXXXXXXXXXXXXXXXXXXXXXXXXXXXXXXXXXXXXXXXXXXXXXXXXXXXXXXXXXXXXXXXXXXXXXXXXXXXXXXXXX-XXXXXXXXX----------------------------------------------------------------------------------------------------------------------------------------------------------------------------------------------------------------------------------------------------------------
