---------------------------------------------------------------------------------------------------
---------------------------------------------------------------------------------------------------
---------------------------------------------------------------------------------------------------
---------------------------------------------------------------------------------------------------
---------------------------------------------------------------------------------------------------
---------------------------------------------------------------------------------------------------
---------------------LSSS---------------------------------------------------------------##---------
-----------------------------------------------------------------------------------K----##---------
-----------------g----------------------------------------------------------------------##---------
-----------------#-------------------------------------------------g#----------------#--##---------
--------SUS-----##---2-----#---------------------------------------##----------------#--##---------
---------------###---------#------T----------------------TT------g###----B---------#-#--##---------
--------------####---------##-----TT---------TT----------TT------####----b--------##-#--##--------F
--M----------#####----kk---##---g-TT----#----TT----------TT-----#####-y--B-------###-#--##--------#
XXXXXXXXXXXXXXXXXXXXXXXXXXXXXXXXXXXXXXXXX-XXXXX-X------XXXXXXXXXXXXXXXXXXXXXXXXXXXXX-X--XXXXXXXXXXX
XXXXXXXXXXXXXXXXXXXXXXXXXXXXXXXXXXXXXXXXX-XXXXX-X------XXXXXXXXXXXXXXXXXXXXXXXXXXXXX-X--XXXXXXXXXXX
