------------------------------------------------------------------------------------------------------------------------------------------------------------------------------------
------------------------------------------------------------------------------------------------------------------------------------------------------------------------------------
------------------------------------------------------------------------------------------------------------------------------------------------------------------------------------
------------------------------------------------------------------------------------------------------------------------------------------------------------------------------------
-------------------------------------------------------------------------------------------------------------------------------------------------------------------------XX---------
-------------------------------------------------------------------------------------------------------------------------------------------------------------------------XX---------
--------------------------------------------------------------------------SUS---------------------------USSS-----------------------------------SSSSS---@-------------C---XX---------
-------------------------------------------------------------------------------------------------------------------------------------------------------------------------XX---------
-------------------------------------------------------------------------------------------------------------------------------------------------------------------------XX---------
-------------------------------------------------------------------------------------------------------------TT----------------------------------------------------------XX---------
-------------------------------------------------------------------------#####-----------------------TT------TT-----------------------------C--------!--------------SS---XX---------
-------K--------------------TT-----TT----K-------------------------------#-----------------TT--------TT--tt--TT----------------------#---------------------TT------------XX---------
----------------------------TT-----TT-----------------------------------K#-----------------TT--------TT--tt--TT------------------K---#---------------------TT------------XX--------F
--M-----------ggg---------kkTT-----TT-----------ggg-------ggg------------#---------------kkTT---ggg--TT--tt--TT-----k----------------#-----gg-------K-K----TT--------k---XX--------X
XXXXXXXXXXXXXXXXXXXXXXXXXXXXXXXXX--XXXXXXXXXXXXXXXXXXXXXXXXXXXXXXXXXXXXXXXXX----XXXXXXXXXXXXXXXXXXXXXXXXXXXXXXXXXXXXXX---XXXXXXXXXX--XXXXXXXXXXXXXXXXXXXXXXXXXXXXXXXXXXXXXXXXXXXXXXX
XXXXXXXXXXXXXXXXXXXXXXXXXXXXXXXXX--XXXXXXXXXXXXXXXXXXXXXXXXXXXXXXXXXXXXXXXXX----XXXXXXXXXXXXXXXXXXXXXXXXXXXXXXXXXXXXXX---XXXXXXXXXX--XXXXXXXXXXXXXXXXXXXXXXXXXXXXXXXXXXXXXXXXXXXXXXX
