------XXXXT-TK-XXXX---K------
---------XXXX---XXXX----#----
----------XXXX-----XXg--#----
------------SXX-----XXB-#--#-
--------------X------XXXX--#-
----------------------XXXX-#-
-------------------------XX#F
--------------------------XX#
---------------------------XX
----------------------------X
----#o-----------------------
----#------------------------
----#-#----------------------
--M-#k#----------------------
XXXXXX#y-----T---------------
XXXXXXXXXX-T-t--X-----S------
