----X----------------------XXX---XXXXXXXXXXXXXXXXXXX----X-------------X-------------------------------------------------------------------------------
------------------------------------------------------------------------------------------------------------------------------------------------------
------------------------------------------------------------------------------------------------------------------------------------------------------
------------------------------------------------------------------------------------------------------------------------------------------------------
------------------------------------------------------------------------------------------------------------------------------------------------------
------------------------------------------------------------------@-------------------------------------------S---------------------------------------
--------------------------------------------------------------------------------------------------------------S---------------------------------------
------------S-------------------------------------------------------------------!---------------------------------------------------------------------
-------t----@-------------------------------------------------------------!----S----------------------------------------------------------------------
------------------S--------1-------------------------------------------------------------t-##----------------S----------S-----------------------------
----------S------------------------------------------------t------------------------------##-@----------------------S---------------------------------
-----------------------------S---tt------------------------------------------g------------##t--#--------t-------------t-------------------tt----------
------------t--t-------t--------------------------------L-t-------------t-----S----t-t-tt###X-###-X-XX-XgS--------g-------g---t----g-t---t---------t--
-------tg---#-----Xtt--t---------ttL-----#t---t------------------------tt--t------ttt-#-##X#--XXXXXXXXXXXX--XXXX-XX-XXXXXXXXXXXXXXXXXXXXXXXXXXXXXXXXXX
XXXXXXXXXX--XXXXXXXXXXXXX-XX-XXXXXX--g---t--t-t###XXXXXXXXXXXXXXXXXXXtXXXXXXXXXXXXXXXXXXXXXX--XXXXXX-X---XX-XXXXXXXXXXXXXXXXXXXXXXXXXXXXXXXXX-XXXXXXXX
XXXXXXXXXXXXXXXXXXXXXXXXXXXXXXXXXXXXXXX-XXXXX#XXXXXXXXXXXXXXXXXXX--XXXXXXXXXXXXXXXXXXXXX-X--X----------------S--------X-------------------X-----------
