--------------XXXXXXXX#--------#-X##---g--#-------------!---------------------------------------------#-------------------------------------------X---
-----------------X--XXXXXXXX-XXXXXXXX#XXXX--------t----T-----!--t--------X-!-----------------------@-------!------------------------------------------
-------------------------XXXX-XXXXXXXXXXXXXXX--g-------------t------#---!----!#--------------K--#------------S----------------------------------------
-------S---------------------------------XXXXXXXXXXXg--------------------#---##---S------X----------!----------S---------!----------------------------
------S-------------------------------------XXXXXXXXXXXXX-t------------------t------!!-----------@-#----------------------------S-S-------------------
-------------S-------------------------------------g-XXXXX-X-XXXXXXX-XX-T---g##-----#-T----X-#----------------------------------------!---!-----------
----------@----S----------------------------------------------X-XX--X-XXXXXXXXX---T------#-----g------------------S-------#--------TX-----------------
-------------X---------------------------------------------------------XXXg-XXXXX-#XT#------XXXXXXXXX#------------#g------------------U---------------
----1------------------------------------------------------------------X------XXXXXXXXXXX#X-----XXXXXXXXXX#---X--#-----T------T#-S--T#----------------
---------T--------!--S--------------S--S--SX-------------------------------------X-XXXXXXX--------------XXXXX--XXXkF--------T-----T##T#------------X--
----------------T------!-!----------------SS---------------------------------------------------------------------XXXXXX----#-#----#-T#-k--------------
----#--g-------#tg----#-------------------------------------------------------------------------------------------X-XXXXXXXXXX---g#-gT--------------t-
----X--X---t---###----------------@-!--------------------------------------------------------------------------------------XXXXXXXXXXXXX--XXX-#-------
----XXXXX-Xg--#t-----------------!Tt--g----------------------S----------------------------------------------------------------XXXXXXXXXX---X-XXXX-g---
XXXX----XXXXXXXXM------#-------t-T----#----g----------------------------------------------------------------------------------------------------X-XXXX
XXXX--------XXXXXXX---#------------g-------U------!!-------------------------------------------------------------------------------------------#-----X
