----XX---X---X---#XX--g----XX#--------X---X--X-----------XXXX-g-TX-------X---XX-X-------#X--T-------#-X---X--T-------X-t---X-X--X--XXX-XXXg-XX---X#--#
----XXt---##-X--#S----X-X--XXX-k----------X-T-SXX----------XX#--K#------#---------------#X--X-------X#X#-----#-------X-X---X-X#-X--XXX-XXTX@X--tT-X--T
------X----#----X--#--X-X----X-X---g---t----g--XX-#--#-----U-X--X#---#--X--#------------X--#--------XX-T-----XS----#-C#X-tg--X#----#-X-S---X---XX-X--X
------X---XX---#XT-t-----#t--X-X---------#-TX---X-X--X-------#--XXX--X-XX--Xg--tt------#T----#-------T-X!-#--X#----#--X--#X--XX----X-------X--XXX--t-X
-------#--XXX--X-X-X----XX-#---S-#-X-X---#-#X-----X##X-----------XX-#X-XX-XXX--X-------XX----X-X-K---X-XX-X-X-X----XX-X--XX---X-S--XX---------X-X--t--
-------###-X---X-X----X-XX-T-------XXX---X-X-X--#--X----#---X-------#--XX-XXX--X-----X-XX----X-X-X---X-XX-X-XK--X--XX#---X-------T-XX---X#--#-KK-T#XX-
-------XX#-----Xk---------T--#-#----X-#--X-X-X--XK-X#X--#t--X-S-----X-----#-X------#-X------#----#--#X---#--XX--X--X-X---X-------X----X-XX--X-XX-XX-X-
-------XXX------X-X-X----#X--X-XX-----#-gX------XX--XX--XX--T-----g-X-X------------XX-------#--#-X--XXg--X--tX---#---X-----#----XX--g#X#-X#-X#XXXX#g--
------X--XS-#-#-X-X#X-----X-#X-XX-----X-T---X----X--X---XXT-------#X--X----#-#-----XX-#-----X-#X-X--#-X--X-#X-------T--X#T-X#---X---X#-----TXX--XXXX--
------X-----X-X--#X---------X--X------X-X--gX-------T-##--X--t----XX-k-----X-X-------#X----#X-XX------X----X#---XT--X--TX#-X-g--X-X#-X--X--XXX----XX--
-------T----X-X--X------S---X#---------X--#---X-----X-X#-----T---S-X-X-----#-X--X----XX----X--X-K---t------XX-#-XXX-X#--X#T-#X----X#-X--t--X---#--X---
-----X-X-#----#--X-----------X---#-----X--Xt-tX-----X-TX-----X-------X#-#-t---#-X----X---X-X----X---T---------#--XX-XX--XX--XX----#X--#XX##----X--X#g-
-----X-X-X----t--------------X--#Xg----X--##-#----X---XX-----X----X--XX-#---T---X--t-X---X#-----X---#-#-----t-X--XX--X-K-X#-X--#g--X--XXXXX---#X---XX-
-----X-X-X#---X-----#-----------#XX---XX--tX-X----X#-t-X----T-X---X---X-X---X--K--SX---XXXt---------X-X-#--#X-X---X----T-XX-X--XXX---TX--XX---XX--tXX-
XXXX-X-#--T---X-----XX------#---XtX---XXt-XX-X-t---X-X-----#T-X-#-X---#---gXX--X-t-X---XX-XX-S------X-X-X--XX----------X--X----XXT---X---XT--Tt---X#X-
XXXX-T#---X---S----#XX------#T--X-X----X--XT--X----X-X----X#X-----X-------X---XX-X---k----XX--------X#XXX--X----------tX----#-#--g--#Xg-#-M--#X---XX--
