------#--X----#-----SXXXXXXX---------------X--XX-----------------------------X-----------X-K-X--XgT----X----------gX--------XXXXXX------------X-------
------#------F------S----XXX----------X---XX-------------------#---------------------------X-----XX---------------XX---#-----X---X--------X---X-------
----#X#-X---X#-------C------X---------X---X--------------------#------------------2-----S-X-X----XX--------------XX-X--#----------o------------X------
----#XXXX-X#XXX-------------X------------------------------#---#--------X-----------------XXX--------------------X-----#-X---------------g-----X------
----#-XX--X#-XX--------------X---------------o-----X-t-----#-|S#--------X------------------X--------------------------XX-T--------------XX------------
----#------#--X--------------XX--------------------#-#----X#-t-X-------X---------------------------------XX-----------XX-T--------------XX-----------X
----#------#--------#---------X-------------------X#-#----XX-X--X------X-------#--------------------X---XXX-------------XT-------------X-------------X
----X------X----X--#X----------------X------------XX-XX----X--XXX--------------#----X---#---------------X--X------------XX-------------X--X------#--X-
----X------X----XX-#X----------------X-------------X-XXX-X--X-XX---X------X----#----X---#-------------#----X---------X---X----------------X------#--X-
-----------------X-#-----------X-#-------------X-------XXX--XX---XXX------XX---X--------#-----------X-#-----X--------X--------X-------#-S---X----#-X--
------------------X#F-----F----X-#--#--#-------#--------X-S--X---XX---X----X---X--------X-----------X-XX----XX----------------X-------T-----X----#XX--
------------------XXS-----#---------#--#-X-----#----X-----------------X-----X---X--XS-XXX----------T--XX-----X--------------T-------XgT----X-----#X---
-------------------X------#------#-XX--X-XX--X-#----X-----------------------X---XX-X--XX-X-----g-#-T------------------------T-------XXX----X-----X----
--------------------------#------#-XX-----X--XX#----------------------------------X------X-----XX#-T------------------------T--------XX----------X----
XXXX------#------------C--#-----XXX-----X-----X#-X--------------------------------X------------XX#-T-----------X------------X-------------------------
XXXX------X-----------XXXX#-----XXX-----X---g--XX-----------------------------X-----------X---XX-X-X----X------X----g--X----XX-XXX------------------X-
