--------------o---------X-
--------------------------
--------------------------
---------------------S----
---------------------S----
--------#------------y----
--------#------------S----
--------#--K--#----@-S--S-
----X---#-----#------S----
----X--Y#----g#------S----
-----XXXXXXXXXXXXXXXXS----
-----XXXXXXXXXXXXXXXXX--#-
---------------------XXg#-
--M--S----------------XX#F
XXXX-------------------XX#
XXXX--------------------XX
