----#-X#---Tb---S--X----------#---------#-------B----#---------XT-#-----X-------#--X------------------XX------X----------X-X----T------K----X--k------
------------------X-----X--------S------#---X---#--#---#-----------#------------#----S-----X-----------X--------X-----X--X----------------------------
-----X#-#------#--------X-------#-------------------S--X--#-X-X--X-----X---T-B---------------------------------X--------#----S----T---T-----------X---
---------##----X---X-#---X------------#-#-----X---#---S--------------#---X--------#-------X---------XX--#-------S-#----S------------------------------
------------#---X----S-#----------X-----#---S#-S-X-------#-----X------------X-X-------------------T-#-#----------#------#-T-X-X--#--------X------S--X-
-----#--#-X------#----X---#--S-------##---X------X----------#X---X----------X-X------X---#-X--S#------------------------------S-K---------o-X---------
------#-------#-------------#---------------T-T------------T----X--S---T-------X---T---#-------------S---X-X--------X#--------S------X-----X--S-------
---------------------X----------T--S----ST------X---T---------T-----------#-----------------X----#--SX------#----------#---##-#---#X-------S--------X-
----------------#-----------------X-#-T--T------------------T-------X-X----#------------X-#------------------------------#--T----------#---X------#---
--------------#--#-----XXB--------X--S---XX--------------------#---T--SX-----S------#-----XX--##-##--X#----#----X--------------------------S-X--------
-------------X-----------------#-X---T----X-X-S-#----#------X#------------XT----T-------X--X-----------S---------X----#-------------T-----------------
----------X-----T--X-T------#--------------------------#---S--------X-T--#---------TX----#--#----------S---------------------------S-----X------b-----
--------X---------T--X----#-#-X------#X-TS-----------------------------------T----------#-XX------S--------------T-----#-X--X---------X------X--X--#-X
-------#X-S---------------XX-----#--------------X----------X--X-----X--X----------#-T---------#-------#XX---X----X------------T---------X----------#--
XXXXXX----TT----TX---------------#X------------X--X----------------#----XX----------------X-X----#-------------------------!X---S------#--------X-----
XXXX--SX-#-X------------------S------------------T-----------X----------------X----XX---X----X-----#----------------------#--------S-----S------------
