---------------------------------------------------------------||----||----XXXXXXXXXXXXXXXXXXXXXXXXXXXXXXXXXXXXXXXXXXXXXXXXXXXXXXXXXXXXXXXXXXXXXXXXXXX
------------------------------------------------------------------------------------------------------------------------------------------------------
------------------------------------------------------------------------------------------------------------------------------------------------------
-------------------------------------------------oo---------------------------------------------------------------------------------------------------
------------------------------------------@-----%%%%--------------------------------------------------------------------------------------------------
---------------------SSS-------------------------||------------------------------------------------------------------------------------XX-------------
-------------------------------------------------||-----------------------------------------k------------------------------------------XX-------------
-------------------g----------o----ooo------r----||--SSS---o-------oo----------------------##--------------2-----------------------C---XX-------------
---------------%%%%%%-------------------%%%%%%---||-------%%%-----------------------------###------------------------------------------XX-------------
----------------||||----SSS--------------||||----||--------|------------------SSS--------####------------------------------------------XX-------------
----------------||||----------------%%%%-||||ooo-||--------|----------------------------#####------------------------------------------XX-------------
-----------%%%%%||||-----------------||--||||--r-||--------|---%%%%--%%%%---------------#####--------------2----------------------SS---XX-------------
------------|||-||||-----------------||%%%%%%%%%%||--------|----||----||--------------#-#####----------------------------TT------------XX-------------
------------|||-||||----oo---%%%%%%%-||-||||||||-||--------|----||----||-------------##-#####--------F------------F------TT------------XX--------F----
XXXXXXXXX---|||-||||---%%%----|||||--||-||||||||-||-------%%%%%-||----||---------r------#####--------#---y--y-----X---y--TT--------k---XX--------X---y
XXXXXXXXX---|||-||||----|-----|||||--||-||||||||-||--------|||--||----||----XXXXXXXXXXXXXXXXXXXXXXXXXXXXXXXXXXXXXXXXXXXXXXXXXXXXXXXXXXXXXXXXXXXXXXXXXX
