-------------------------------------------------------
-------------------------------------------------------
-------------------------------------------------------
-------------------------------------------------------
-------------------------------------------------------
-------------------------------------------------------
-------------------------------------------###---------
-----------------y-------------------------###---------
---------------#SS--o-------------------y--###---------
--------------##------------------------#--###---------
-------------###--SC-------------------##--###---------
-------K---y####---------------------y###--###---------
-----------#####---SSS---------------####--###--------F
--M-------######--------------------#####--###--------#
XXXXXXXXXXXXXXXX------XXXXXXXXX---XXXXXXX--XXXXXXXXXXXX
XXXXXXXXXXXXXXXX------XXXXXXXXX---XXXXXXX--XXXXXXXXXXXX
