--------XX---------------XX----TT--------
---------XXM----o---------XXg--TTK-------
----------XX---------------XX------------
-----------XX--k------------XX----#------
------------XXXX-------------XX---#------
-----S-------XXXXg-#----------XXXX#------
----------------XX-#-----------XXX#------
-----S-T-S-------XX#--------------#------
-------T----------XXX-T-----------X------
------ST-----------XXXT-----------X----o-
-------T---S---------XT#-----------------
----------------------X#---T-------XX----
----------------------XX--#T-------XXX--F
--M---#----------------XX-#TS--------XXXt
XXXXX-XXX---------------XX#T-#--------XXX
XXXXXXXXXX---------C-----XXT----T-------X
