----XXX--#-----------T--------XX--------#-------
-----XXXX#-----------T---------XX-----#-#-------
-------XXXXX----#!---T----------XXXXX-#-#-------
---------XXXX---#---ST-----------XXXXX#-#-------
------------XXX-#----T---------------XX-#-------
-------------XXXXk---T-----T----------XX#-------
---------------XXX--oT----CT-----------XXg------
-----------------XXXXXXg-T-T#-----------XX------
--------X---------XXXXXX-T-T-------------XX-----
-----------------------XXT-T--------------XX----
----------#S------------XXXT-------SC------XXX--
----------#---------------XX----------------XXXF
------#---#-----------S----XX-----------------XX
--M-g-#---#-----------------XX--------#--------X
XXXXX-#---#---------!--------XX-------#---------
XXXXXXt---#-------------------XX------#--#------
