-----XX----
------XXM--
-------XX--
--------XX-
---------X-
-----------
-----------
-----------
-----------
-----------
----X------
-----------
-------S---
--M--------
XXXXXX---SF
XXXXXXX---#
