--------------------------------------------------------------------------------------------------------------T--------------------oo--------------T--
--------------------------------------------------------------------------------------------------------------TT-----------------------------------T--
-----------------------------------------------------------------------------------S--------------------------TT--------------ooo-----------o------TTT
-----------------------------------------------------------------------------------------------------SU-!-----XT-----------------oo---------------SXTX
---------------------------------------------------------------------------------------------------------------T------------tt-----------TT---------T-
---------------------------------------------------------------------------------------------------------------T------------tt-----------TT---------T-
------------------------------------------------------SSS----------------------------------g-gg----------------T------------tt-----------TT---------T-
------------------------------------------------------------------------------XXXXXXXXXXXXXXXXXXXXXXXXXXXXXXXXXXXXXXXXXXXXXXXXXXXXXXXXXXXXXXXXXXXXXXXX
-------------------------------------------------------g---------------------SXXXXXXXXXXXXXXXXXXXXXXXXXXXXXXXXXXXXXXXXXXXXXXXXXXXXXXXXXXXXXXXXXXXXXXXX
------------------------------------------------------------------o-----------------------------------------------------------------------------------
--------------------------------!------------------!--SSS----------------TT---------------------------------------------------------------------------
--------------------------B--------------------#-------------------------TT---------------------------------------------------------------------------
----F-------------TT------b--------------------#-------------------------TT---------------------------------------------------------------------------
----#-------------TT---g--B--------------------#------------K------------TT---------------------------------------------------------------------------
XXXXXXXXXXXXXXXXXXXXXXXXXXXXXXXXXX-----XX--XXX-XXXXXXXXXXXXXXXX-------XX-XX---------------------------------------------------------------------------
XXXXXXXXXXXXXXXXXXXXXXXXXXXXXXXXXX-----XX--XXX-XXXXXXXXXXXXXXXX-------XX-XX---------------------------------------------------------------------------
