----XX--#-------XXXX----------X-------S--S--S----S---X#-#-----------
-----XX-#---------XXX---------X|-S----S--S-------S----X-#-----S-----
------XX#r----------X-----S----X-S------------#o-S----X##-----------
-------XXX-----------X--#-------XS---S------r-#--------X#S----------
-------SXXX----------XXX#-------XS------------#--------X#X----S-----
----------X--------S--XXX--------S----S-------#---------#X--T-------
-----------X------------X------o-S--S-----oX--t---------X-X-TK------
--------o--X-------------k-T-----S---------XX-#---------X-XXT-------
--------S---X------------X-T--SS-S----------Xgb----T-------XT-----#-
--------S---X-#---o------XXt-----S-----Xg----X#XX--T-2------Xy----#-
--------S----X#-T-----oo--XT-!--o-X----XX----XXXXX-T--------XX----X-
----------S--XXgT----------X----SSXX-#X-XX-S--X--XX------#---XX-y---
---------#----XXt----------Xg---S--XXXX--X-S------XX---#-|----XXX--F
--M------#-----Xt-----------X-------XX----S----S---XX--#-#-----XXXkt
XXXXX----#------Xg--to------XXX-----------S-----S---XX-#-#-------XXX
XXXXXX---#------XXXM#-----o--XX---S-------S----------XX#-#S--S-S--XX
