--------------------------------------------------------------------------------------------------------------------------------------------
--------------------------------------------------------------------------------------------------------------------------------------------
--------------------------------------------------------------------------------------------------------------------------------------------
--------------------------------------------------------------------------------------------------------------------------------------------
--------------------------------------------------------------------------------------------------------------------------------------------
-----------------------------------------------------------------------------------------------------------------------K--------------------
-----------------------------US------------------------------------------------------------------------------------SSSSSS--------##---------
--------------------------------------------------------------------------------------------------------------------------------###---------
------------------------------------------------------------------------------------------------B------------------------------####---------
-----------------------------------------------------------------y------------------------------b-------------------K----------####---------
---------!!-----------------####--SSC------------------ooo-------##---------#-----------------SS#CS---------------SSSSSSS----######---------
-----------------------y-#####----------------------------------###---------##------K---B-------------------TT---------------######---------
--------------------y-######-----------------------------------####---------###---------b---------K-B-------TT---------------######--------F
--M----------------#######------------------y-y---------------#####----y--y-####--------B-----------b-------TT---------------######--------#
XXXXXXXXXXXXX--XXXXXXXXX------XX--XXXXXXXXXXXXXXXX--XXXXXXXXXXXXXXX--XXXXXXXXXXXXXXXXXXXXXXXXXXXXXXXXXXXX--XXXXXXXXXXXXXXXXXXXXXXXXXXXXXXXXX
XXXXXXXXXXXXX--XXXXXXXXX------XX--XXXXXXXXXXXXXXXX--XXXXXXXXXXXXXXX--XXXXXXXXXXXXXXXXXXXXXXXXXXXXXXXXXXXX--XXXXXXXXXXXXXXXXXXXXXXXXXXXXXXXXX
