------------------------------------------------------------------------------------------------------------------------------------------------------------------------------------------------------------------------------------------------------------------------------------------------------------------------------------------------------------------------
------------------------------------------------------------------------------------------------------------------------------------------------------------------------------------------------------------------------------------------------------------------------------------------------------------------------------------------------------------------------
------------------------------------------------------------------------------------------------------------------------------------------------------------------------------------------------------------------------------------------------------------------------------------------------------------------------------------------------------------------------
------------------------------------------------------------------------------------------------------------------------------------------------------------------------------------------------------------------------------------------------------------------------------------------------------------------------------------------------------------------------
--------------------------------------------------------------------------------------------------------------------------------------------------------------------------------------------------------------------------------------------------------------------------------------------------------------------------------------------------S---------------------
------------------------------------------------------------------------------------------------------------------------------------------------------------------------------------------------------------------------------------------------------------------------------------------------------------------------------------------------------------------------
--------------------------------------------------------------------------SUS--------------------------------------------------------------------------------------------------------------------------------------------------------------------1-------------------------------------------------------!!!!------------------------------------------SSS--------------
--------------------------------------------------------------------------------------------------------------------------------------------------------------------------------------------------------------------------------------------------------------oooo----------oooo------------oooo------------------------------------------------------------------------
--------------------------------------------------------------------------------------------------------------------------------------------T---------------------#----------------------------------------------------------------------------------------------------------------------------------------------------------------------oo-------T---------------------
--------------------------------------------------------------------------------------------------------------------------------------------T--------------------##--oo------------------------------------------------------------------------------------------------------------------------------------y-------------------------y------------T#--------SSSSSSU-----
-------------------------------------------------------------------------#####-----------------------------------------------------#LSS-----#-------------------###-------------------------TT----------------------------------!!!------------!!!!----------------------TT--------------TT------------!!@SS!!!------------ooo-------##------------#--------------------
-------K--------------------TT-----TT----K-------------------------------#--------------------------#------------------------------#---------------------------####-------------------------TT--------------------------------------------------------------#------------TT--------------TT-----------------------------------------###------------#--------------------
----------------------------TT-----TT-----------------------------------K#---------------------*----#------------------------------#--------------------------#####-------------------------TT--------------------------------------------------------------#------------TT--------------TT----------------------------------------####----------#-#---SSS--------------
--M-----------ggg---------kkTT-----TT-----------ggg-------ggg------------#--------------ggg----*----#----ggg--k----ggg-----------kk#----------k---ggg------gg######--k-------k--ggg-----ggg-TT----k-k---------------y--y------------------------yy----------#---------y--TT---y------y---TT---------------------------------------#####------------#----------r--------F
XXXXXXXXXXXXXXXXXXXXXXXXXXXXXXXXX--XXXXXXXXXXXXXXXXXXXXXXXXXXXXXXXXXXXXXXXXX----XXXXXXXXXXXXXXXXXX--XXXXXXXXXXXXXXXXXXXXXXXXXXXXXXXXXXXX---XXXXXXXXXXXXXXXXXXXXXXXXXXXXXXXXXXXXXXXXXXXXXXXXXXXXXXXXXXXX-X-XX-XX-XX-XXXXXXXXXXXXXXXXXX--XXXXXXXXXXXXXXXXXXXXXXXXXXXXXXXXXXXXXXXXXXXXXXXXXXXXXXXXXXXXXXXXXXX--XXXXXXXXXX--XXXXXXXXXXXXXXX---XXXXXXXXXX--------XXXXXXXX--XX
XXXXXXXXXXXXXXXXXXXXXXXXXXXXXXXXX--XXXXXXXXXXXXXXXXXXXXXXXXXXXXXXXXXXXXXXXXX----XXXXXXXXXXXXXXXXXX--XXXXXXXXXXXXXXXXXXXXXXXXXXXXXXXXXXXX---XXXXXXXXXXXXXXXXXXXXXXXXXXXXXXXXXXXXXXXXXXXXXXXXXXXXXXXXXXXX-X-XX-XX-XX-XXXXXXXXXXXXXXXXXX--XXXXXXXXXXXXXXXXXXXXXXXXXXXXXXXXXXXXXXXXXXXXXXXXXXXXXXXXXXXXXXXXXXX--XXXXXXXXXX--XXXXXXXXXXXXXXX---XXXXXXXXXX--------XXXXXXXX--XX
