--------------------------------------------------------------------------------------------------------------------------------------------------------------------------------------------------------------------------------------------------------------------------------
--------------------------------------------------------------------------------------------------------------------------------------------------------------------------------------------------------------------------------------------------------------------------------
--------------------------------------------------------------------------------------------------------------------------------------------------------------------------------------------------------------------------------------------------------------------------------
--------------------------------------------------------------------------------------------------------------------------------------------------------------------------------------------------------------------------------------------------------------------------------
--------------------------------------------------------------------------------------------------------------------------------------------------------------------------------------------------------------------------------------------------------------------------------
--------------------------------------------------------------------------------------------------------------------------------------------------------------------------------------------------------------------------------------K--------------------K--------------------
---------------------LSSS---------------------!!!!!-----------USSS--------SSCSS-----------USSS--------SSCSS!----------------------------------------------------------------------------------------------------------------------SSSSSS----1----------SSSSSS--------##---------
-----------------------------------------------------------------------------------------------------------------------S1SSSSSSSSSSSSS------------------------------------------------------------------------------------------------------------------------------###---------
-----------------g-------------------------------------------------------------------------------------------------------------------------------------------------------------------------------------------------------------------------------------------------####---------
-----------------#------------------------------k--------------------------------------------------------------------------------------------------------------------------------B-------------------------------------------------K--------------------K----------####---------
--------SUS-----##---2-----#-----------TT-----@!!!!----------S-----TT---!!!!--!!!--------S-----TT---!!!!--!S!!-----------------------------------------------S@---------SS------S#2----------------------------------------------SSSSSSS--------------SSSSSSS----######---------
---------------###---------#-----------TT--------------------------TT--------------------------TT------------------------------K-------SS--------------B-------------------------------B----------------------------TT----------------------TT-------------------######---------
--------------####---------##----------TT--------------------------TT--------------------------TT-----------------------#----------------------B-----K-bK----------B-------------------b-----TT----K----TT----------TT-----TT---------------TT-------------------######--------F
--M----------#####----kk---##---gg-----TT------------gg----k-ggg---TT------------gg----k-ggg---TT-----------------------#----------------------b-------B-----------b--y------B--y-y----b-----TT---------TT----------TT-----TT---------------TT-------------------######--------#
XXXXXXXXXXXXXXXXXXXXXXXXXXXXXXXXXXXXXXXXXXXXXXXXXXXXXXXXXXXXXXXXXXXXXXXXXXXXXXXXXXXXXXXXXXXXXXXXXXXXXXXXXXXXXXXX-XXXXXXXX-XXXX-XXXXXXXXX--XXXX-XXXXXXXXXXXXXXXXXXXXXXXXXXXXXXXXXXXXXXXXXXXXXXXXXXXXX-XXXXX-X------XXXXXXXXXXXXXXXXXXXXXXXXXXXXXXXXXXXXXXXXXXXXXXXXXXXXXXXXXXXXXX
XXXXXXXXXXXXXXXXXXXXXXXXXXXXXXXXXXXXXXXXXXXXXXXXXXXXXXXXXXXXXXXXXXXXXXXXXXXXXXXXXXXXXXXXXXXXXXXXXXXXXXXXXXXXXXXX-XXXXXXXX-XXXX-XXXXXXXXX--XXXX-XXXXXXXXXXXXXXXXXXXXXXXXXXXXXXXXXXXXXXXXXXXXXXXXXXXXX-XXXXX-X------XXXXXXXXXXXXXXXXXXXXXXXXXXXXXXXXXXXXXXXXXXXXXXXXXXXXXXXXXXXXXX
