----------------------------------------------------------------------------------------------------------------------------------------------------------------------------------------------------------------------------------------------------------------------------------------------------------------------------------------------------------------------------------------------------------------
----------------------------------------------------------------------------------------------------------------------------------------------------------------------------------------------------------------------------------------------------------------------------------------------------------------------------------------------------------------------------------------------------------------
----------------------------------------------------------------------------------------------------------------------------------------------------------------------------------------------------------------------------------------------------------------------------------------------------------------------------------------------------------------------------------------------------------------
----------------------------------------------------------------------------------------------------------------------------------------------------------------------------------------------------------------------------------------------------------------------------------------------------------------------------------------------------------------------------------------------------------------
----------------------------------------------------------------------------------------------------------------------------------------------------------------------------------------------------------------------------------------------------------------------------------------------------------------------------------------------------------------------------------------------------------------
---------------------------------------------------------------------------------------------------------------------------------------------------------------------------------------g------------------------------------------------------------------------------------------------------------------------------------------------------------------------------------------------------------------------
----------------------------------------------------------------SSSSCSSS-------------------------------------------------------------------------------------------------------------SSSSSSSS---SSS!--------------@-----------SSS----S!!S----------LSSS---------------------!!!!!-----------USSS--------SSCSS------SSSS-----------------------------USSS-----------------------------------SSSSS---@------------
----------------------------------------------------------------------------------------------------------------------------------------------------------------------------------------------------------------------------------------------------------------------------------------------------------------------------------------------------------------------------------------------------------------
--------------------y---------------------------------------------------------------------------------------------------------------------------------------------------------------g----------------------------------------------------------g----------------------------------------------------------------------------------------------------------------------------------------------------------------
--------------------XSS-@!--------------------------------------------------------------------SSUSSSSS-------------------------------oo---------------------tt---------------------------------------------------------------------------------#------------------------------k-----------------------------------------------g--------------------------TT-----------------------------------------------------
-----------------T-XX------------------------------------------#----2----#------------------------------------------------------------------------------TT--tt--------------------S@S--------------C-----SU----!--!--!-----S----------SS------##---2-----#-----------TT-----@!!!!----------S-----TT---!!!!--!!!---------------TT-----------------TT------TT-----------------------------C--------!--------------
-------K---------TXXX-----------------------------TT-----------#------K--#-------K------------------------------------------------------------------TT--TT--tt-------------------------------------------------------------------------------###---------#-----------TT--------------------------TT---------------------------TT----------g------TT--tt--TT----------------------#---------------------TT-------
-----------------TXXX-------y---------------------TT-----------#---------#-----------K----------------------------------#---------------------------TT--TT--tt------------B-----------------------------------------------------------------####---------##----------TT--------------------------TT---------------------------TT----------TT-----TT--tt--TT------------------K---#---------------------TT-------
--M-----------k-gTXXX---SSSSS----------kkk--------TT------ggg--#---------#--------------------------------------------kk#----------------------ggg--TT--TT--tt-----k------b-------------------------g-g--------k-----------------gg-g-g----#####----kk---##---gg-----TT------------gg----k-ggg---TT------------ggg------------TT----------TT--g--TT--tt--TT-----k----------------#-----gg-------K-K----TT-------
XXXXXXXXXXXXXXXXXXXXX-------XX-XXXXXXXXXXXXXXXXXXXXXXXXXXXXXXXXXXXXXXXXXXXXXXXX-X-XX-X-XX-XXXXXXXXXXXXXXXXX-X-X-XXXXXXXXXXXXXXXXXXX------XXXXXXXXXX-XX--XX--XXXXXXXXXXXXXXXXXXXXXXXXXXXXXXX---XXXXXXXXXXXXXXXXXXXXXXXXXXXXXXXXXXXXXXXXXXXXXXXXXXXXXXXXXXXXXXXXXXXXXXXXXXXXXXXXXXXXXXXXXXXXXXXXXXXXXXXXXXXXXXXXXXXXX----XXXXXXXXXX---XXXXXXXXXXXXXXXXXXXXXXXXXXXXXX---XXXXXXXXXX--XXXXXXXXXXXXXXXXXXXXXXXXXXXXXXX
XXXXXXXXXXXXXXXXXXXXX-------XX-XXXXXXXXXXXXXXXXXXXXXXXXXXXXXXXXXXXXXXXXXXXXXXXX-X-XX-X-XX-XXXXXXXXXXXXXXXXX-X-X-XXXXXXXXXXXXXXXXXXX------XXXXXXXXXX-XX--XX--XXXXXXXXXXXXXXXXXXXXXXXXXXXXXXX---XXXXXXXXXXXXXXXXXXXXXXXXXXXXXXXXXXXXXXXXXXXXXXXXXXXXXXXXXXXXXXXXXXXXXXXXXXXXXXXXXXXXXXXXXXXXXXXXXXXXXXXXXXXXXXXXXXXXX----XXXXXXXXXX---XXXXXXXXXXXXXXXXXXXXXXXXXXXXXX---XXXXXXXXXX--XXXXXXXXXXXXXXXXXXXXXXXXXXXXXXX
