------------------------------------------------------------------------------------------------------------------------------------------------------
------------------------------------------------------------------------------------------------------------------------------------------------------
------------------------------------------------------------------------------------------------------------------------------------SS----------------
----------------------------------------------------------------------------------------------------------------------o-------------------------------
-----------------------------------------------------------------------------------------------------------------------------------#------------------
--------------------------------------------------------------------------o--------------------------------------------------------#------------------
------------------------------------------------------------S---------TT--------------------------------------!-------------------##------------------
----------------------------------------------------TT----------------TT-------------------------------------------%-------------####-----------------
----------------------------------------------------TT----------------TT------------------------F--------------------------------###-----------------F
-----------------------------g------------------ggggTT-----k----------TT---k----------y-gg--k---#-----gggg-----gg----------------###----k----k-------#
----2-----------------------##------------------XXXXXXXXXXXXXXXXXXXXXXXXXXXXXXXXXXXXXXXXXXXXXXXXXXXXXXXXXXXXXXXXXXX------XXXXXX--XXXXXXXXXXXXXXXXXXXXX
----------------------------#----------K--------XXXXXXXXXXXXXXXXXXXXXXXXXXXXXXXXXXXXXXXXXXXXXXXXXXXXXXXXXXXXXXXXXXX------XXXXXX--XXXXXXXXXXXXXXXXXXXXX
----------*-------------#---#-------------------------------------------------------------------------------------------------------------------------
----k-----b---kk--------#---#------k-----------k------------------------------------------------------------------------------------------------------
XXXXXXXXXXXXXXXXXXX---XXXXXXXXXXXXXXXXXXXXXXXXXX------------------------------------------------------------------------------------------------------
XXXXXXXXXXXXXXXXXXX---XXXXXXXXXXXXXXXXXXXXXXXXXX------------------------------------------------------------------------------------------------------
