--------------------------------------------S-----#-#-#---S---------------------------TT------SSSSSSSS----------#-#-----------------------------------
--------------------------------------------S-----#-#-#---S---------------------------TT-----------------------g#-#-----------------------------------
--------------------------------------------S---g-#-#-#---S-----k---------------------TT-----------------------##-#-------------#---------U!!---------
--------------------------------------------XXXXXXXXXXX---X-XXXXXXXXXXXXX-----XXXXXXXXXX----##----------------###---------------#---------------------
--------------------------------------------XXXXXXXXXXX---X-XXXXXXXXXXXXX-----XXXXXXXXXXT--###----------------###----------K----#-----------------t---
----------------------------------------------------------------------------------------T-g###----------------###-----------y--k##----------------t---
----------!-!--------SSSSS---SSSSSS---SSSSS---------------------------------------------T-####----------XXXXXXXXXXXXXXXXXXXXXXXXXXXXXXXXXXXXX---ttt---
----------------------------------------------------------------------------------------XXXXXX----------XXXXXXXXXXXXXXXXXXXXXXXXXXXXXXXXXXXXX---ttt---
-------------------------------------------SSSSSSSSSSSSSSSSS-SSSSSSSSSSSSS-----SSSSSSSSSXXXXXX-###-#-----------------------------------------XXXXXXXXX
----------------------K--------------------------------------SSSSSS------S---------------------###-#-----------------------------------------XXXXXXXXX
----------@!!-------SSSSSS-----------------------------------CSSSSS------S---------------------###-#--------------------------------------------------
-----------------------------------------------------------S-SSSSS-------S-SSS----------------XXXXXX--------------------------------------------------
--------------K---------------------------------------------------------------------------SSSSXXXXXX--------------------------------------------------
------------------------------k----ggg-------------------------------------------------T--------------------------------------------------------------
XXXXXXXX--XXXXXXXXXXXXXXXXXXXXXXXXXXXXXXXXX-------------------ooooo------2----S--------T----------------------------------------------------S---------
XXXXXXXX--XXXXXXXXXXXXXXXXXXXXXXXXXXXXXXXXX----------------S-SSSSSS------S-------------TTS------------------o----g------------------------------------
