-------X---S-X--------XX----X---T---------------X--X--X------g-------K---XS-X-X-X---#----X----X-XS-X--X-T---XX-X----XX----X-TX--X------T-K-----X-X----
----X---X--X----t-X--X-SXX---X--S!-X--S-----XX---T---X--X-X---T--------------XX-S---#--gX----------X-X---T-T------X--X--X-X---X-XX-X----SX-----T--X-SU
------XS#-X-X-----X------Xt--XX--#-------------------XXC-X-TX------X-XT---X-CX--X-----S-X---T--X------X--tX-X--X--XXX---X---X-TX-XXX---X-----X-------X
------XX-----#--T-----------!---X--S-X-----K-t-X--X--#--XS--#-XX----------T-X----X!---g--------------X---------------X------X-------#-----X-----------
------g-----X--------#---X---XX-----XX------#---------K------#-X-XX--XS---X-X------X-------X----------X---XX-g-X-X------X--XX--#-X----X----XS-X---XX--
-------------X-------XX------X-!--X---X-------X-X-----X----X------X-------S--X---X-XXX---X-X-----X---XX---X-Xg-----#-X---------T-X#-----X-KXX------X-X
--------T-XX---TX-----------X--X-XX---------------X------X-----X-----gXXX---X-#------XgX-----X---------S----SX----XX-X-----------------------XT--X--X-
----------X-T--XX--X---X----XX@S----g-XX-X------X-X-XX-----T---------T-X------XX--X#-X---X-S-XX--XXSg----X------X-X-t-X---X-X-------XX------X-TXX---#-
----X-----------X--t-------X-#---X-XX--S-X--X-!--------X----TXg--------XXX--------X-------------X--XX-X----#------X----S----------XX-----T---X--X--#--
----CXTX-XX--g-----XXTgX---------#--X-X-X---t----------#---X#----XX--------X--!--------X-X---------------X---XX---t--XSX--X-X-X----!---XX-------X-----
-------X----XX-------X-XX-X--#X----------X-------X----X-X----X---X-X----X-----X---XX-------C-X---X-XXX-X------X--Xg-------T------X--------X#SXX-----X-
------X---XX--X--X-T-T-X---X-XXXX--------!--t----XX------X---XX-X----------------------X---X-#--X-X--X-X----XX-------X--XX--X--X----T--S#----XX-X-----
------XX--XX--SX-X----X-X---S----T-Xt-XX----X----------T-------SXX-----X-X--T-X---t-----X----X-X---------------XX-X----X-------T-TXX--X-#T---CX---X---
-----X----X---X-XX-------X-X-#--T---X-----X------------------------X---S-----X-XXS---XX-----g----TX-XTS-----------X--XX-SX--X---XX--X--------X-------X
XXXXXT---T---------X---X--k----S-X---S--Tt-X-X-------X--#---!-----X------S----@-------#--#XX---T--X---XX-X---X-----X-XXgX--XX--XX--X----X-X---#X-----X
XXXXXS--t---------------XX-X----X-X-------XXX--X-----X-------X-----XX--#-------X--#--X-X-------X---X----X----X-T---XX-----S-----!--X-XXX---XXX-----T--
