----X----X---T--X-----X-XX--X----X-----XT-XX-X---U-----M--S-----X---tXX----------X--X----X#X-------X--XX-!-T---T----X-------T---------X-T-----X-------
----X-XX--------XX--X--X----XX-T-g-X-X---T--X----X---X--T-X---X------XX--TX-X-X---T-----S--g----X------#-----------X------S----X-Xg-X----------X------
--------X-----X---X-----X-T----------C-------X----T--X---#X-X-k--X-TX--FT--X-X----T-X-X---------g--#XT---X---XTX---X----X--------K---t---X---X--------
---------t---XXSX---XX---T-X----X!-----X-----X--t----g----------T----------kgX--XXSX----T--X--g--#-X---X-------------X--------@-#XX--kX-T----T---X----
--------g-X-X------X----XX-X-TX--X------X-------#----X------------X--X---X-XT--X----XX----X---T--S--X-------X-X--X-------------------T-X----XX---X---X
-----XXX---FX---X---------XXX---X-XT----------X--X----XX--X----X-X---X---X-X-----XXS----------X-----X--XX--X---------------------X-----X--------------
--------XSS--X!X-X---tX--------@-----------X-X-----X---X--X----X---TX---TX--------X--T---XXX-XTX-----XX--X------X--@XXX-X----X-----------X--#---X---S-
--------X-X----S-T-X--T----XXX-T------------X--t------------------------X--!-X---X-X-X--XX------------X---X-----X---!-X--------X--X--T---T--X----X--X-
------X-XX-X----X-X--X---XXX-XX------X---XX--X-@---------T-X----XX---!X----T---------------g-XX---X---X----XX-T-S-X-t-----------XSX---------X------X--
-----X--X----XX-X--------X---TS-X-X--X#--XX-#-X----S--X---------T-XX-------XX------TT-X-X--X-----X---X--!-XX----------S------X---X-------XX---X-T---XX
-------X-----X-XX-----X-XX-tX--X-X-S----XX--X-XX---S-T-T------#--------------X----X---@X---------X---X-SX---------------XX--X--------X---------X---X-X
-----X#-XX-XX-------t--g-X---XT---XT--X--XX---TS------T--g-T-X---------X-XXX-X-X----g--X-----X---X-XS-X----------X------X-X--X-XX-----X----X-XX-------
----------#-----X---X------X-X-----C-S----X-----X-------T-----X---X-X---XX--T---X-#-X----T-----X---X----X---X-----X-----@S#XX---g--XX---XS-------X----
----------X--SX---X--------------X-X-XS------------SX-S-T-T-----------X----X-X-X--X------X---X-#-X--X----------X-S-X---X---t----------------XX---X!#S-
XXXX----S-X#---X-X-------XX-X-g--X------------X-X---XX----S------X-#---X-------X-X----X-XX--T---------X------TX-X---X----X----------X---------X----X--
XXXX---X-X----------X----Xg-X-------X-------------X---X-----XS-X-S-X-SX-#-X-X--X---------t--T-X----XX--X---X---X--X-------X------XXX-------------XTX--
