------#-g##----XX-U----X--#-----X---X---#---X-------X---X---#----#----X----#---#X----X#----#-----X---!--X---#X#----#------#-----X---XX-X----X-----##X#
----------#-X---#X#X--#--XS--------X-------#-----#g---X---X-#-------#-X---------##---t-------XX---X-X#-XX---------XX---X--------X---X#-#-X-XXt--#-XXt-
-------G---#X---#-X-SX--#---#X-------#-----X##---#X----#-##--X--#---##--X----------X----#X--#---X--X-X---#---#----X--X#---#-X---X---#XX-----S--------#
---------#---------#----X---#--------XX--#--#------#-#---X--#-----XX#--X--#--------X------#X-----#---X--XX--------#------X##----#XXX--S##----------g-X
-----S----##------X-#-#--------------X-X---X--------X--X---X--------#----#------X---#-----#---------X--X--#S----XXX---r----------X---#-#-#X------XXXX-
-----X-----------#---X#---X-----X##---X-#--------X-----X#-#-------X----#-X#------gX-X#--X#X-----#---------X-----#XX-X-##-X-------XX##-----S--------#-t
----XX--#-------#--Xt------------------#X#--------#X---XX-------X-----X--X--------#--X--#S------#-----X##-------X-X-###-!-------#----#---t------X--S--
-----X-----------XX#--#-------------------------XX--#-#-#---------X-X---------------#-XX------------------------X-X##t###----------##--#----------###-
----X-X----------XX---------------#---X-------------#-S----------X-#--X----------t##--#X------------X-----------XX--#-------------#-------------#-----
---------------------X------------#--##-------------#-----------X#--------------X----------------XX---#---------C--XX-X-------------#SX------------X--
------------------#---------------X-UL-------------X-------------#-XXX--------------#-------------X-X---------------------------#---------------------
----X-----------#--#!--------------#----------------X--------------#-------------X----------------XX-------------X--#---------------------------X-S---
-------------------#---------------#--------------#--------------XX#--------------X-------------X-------------------------------#--X------------XX----
------------------X-----------------------------------------------X-------------X--------------------------------X---------------XX-------------------
XXXX-----------------------------U----------------------------------------------g--------------------------------X------------------------------#-----
XXXX----------------------------------------------------------------------------#-----------------------------------------------X---------------------
