------------X------X----X--X----------------X--X------tX#---X--X--X-----#----------X-X-----X---------------------------------X----X--------------X----
-----------X---X-------X-X----X-------X--X----------------X-X---#------------X-X--X-X-----X-XX-----X---X----X----X------X--k---------------#----X----X
-----X-------#--X-------------t------X-#-------X--------X------#-L-X-X-XX-------------Xt--X-----------X--X----X--X----X-------------X---------X-------
-------------X---k--------X---X---X-----------X-------X------------------X--XX-X---------------------X---X---X-X-#-#X---F-T---------------------------
---------X------------------#------XK#----X-----X---#-----X-------X--------X--------------------X-----Xy---X-X-XX------X------------------------X----X
----------------------------------------X--#--T-------o-----------S----#-----------X-Xg-------y----------#---X-#---------------X--------X--------KXX--
-------------------#-------------X-R------------X----X------X----X----#----X--#----X-------X--X------k------X-X--------XX-----------------X--X---X----
----X---------X--X-----------------XX--------#--#---------------------XX------X-#-X----------X--X---XX---------XX---X---------------------------------
------------------X--X---X-X-----------------------T-------------XX---X------------------------------X---S--X-------------X---------X-F-----------X---
------X------X---------#---X-----X---X--X---------T----XX------X----S-----X----------------------X--------X----X--X-------------------------X---------
-----X-----X%--X------y--------X-------X-------------XX--------#------X----#---T----------T----X-------------------X-XX--oX--------------S-----X------
------X----#----X-------X-----X--------X#-#------TX-----X--------XX--#----#----------#XX-----------X---#-----------T---------------XX------------X----
----#--------X----------#---X---#X---X#---X----X------X---X--X----T--------------k----------------------XX------------XX---------------X-------------X
----------k-------#-----------------X--X---------T--X-----X-----X-XT------#----------------------X--------X--X---XT-X----------------X--X-----XX----X-
XXXX------------X---t-----XX------------------X---X-------X-------X----------T-U-----T-#----X-------------------------------X-----X-------U-X-X-------
XXXX--X------X-------#X-XX----XX-----------X----X-#-------------X----X-------------X-----------X---X------X-------------#--------#-----------#XX---X--
