----X---X-X------gX--#--X-g--X--X-#---X---XXX---SX--------X----Xg--X----X--XT----k------X--X-----X-----------X--X------X--X---X------XX-----X-X-----X-
-----------XXTXX------------X---X--X-----XX-------X-XX---S----X----X--------#--X-----X-X-------------X#--XX------XX-----------!#---X---X--XSS-----#X-X
----S-----X------X---!--X-X-XX--g-------tXX--------------------#-X--X--XX---g-----------XX---S----S-X-X--X--------g--X--X-XX-X-----X----S---XX--X-----
------X--X----XX----t-----------X--S--------X---S---XX------XT---X--S---X----X------XT-XXg---------X-X--X--------X-XT------------X--XX--------X--SS-X-
--------XtX-S-X--SX-X-------X----XX-XX--------X--X-X-X---#X-------XT-------------X------!-------X--X-----SX--------X-XXX----------XX-X--------X------X
----XX-------X-X---S------XX--X--X-X-----X--SX-----X-X----------##X------X------X---X--X----XS--XX-----------X-----X-----X----XX------------X--T------
-----X-Tg------##--------XX----t-------------S!-T--XXTX-g------X-----TX-X-S-------X--X-----X--X-X-------XX-X--X--X-----#--T-XX---X-X-TX------X--X--S--
-----X---X--X-SXX-X---XX----F-----X--#-XT-----T-----X-!-XS---X--t-X--------X------t-----------X--SX--S1------X-----XT-X--X-----X----X-X------X---XT---
----XT----X--#----XX--------tX--XX--X#X---g-----Xt-----X--XX#X--------X----X-----X--XX------tX-#---------------X------XX--X--X--TX--X----!-X---XX----X
---------XX-------------X----------XC--X----gX------U-g----X-S-------S----Tg-----------X!--TX-----------X--------------X------gT---X------------------
-------X-XS-----Xg-X-X------XT---------XX!X-X--X-TX-X--X--K------X------X-----X-X----X----X--X-------------T--XX-X----------X--S-X-XX---X-#------X----
-------XT-----XXX-TX--#----t------X--X-------#--T---------!-X--XD---#--X--XX---X----X-T---XX------t-----------X--S----X-----X------T-------X-X----X---
-----X-------X--------------X-------------------T----X-X------g---X------#----#-XXC--X-X----XXX-----X-XX----X-X-X---------X-------X--#--------------tX
----X---X--X---SX---------X---X---X-------tX-------XX-X---!-X----g---------#-X-------X------X---X-X-X------XU----X--X#------X-X---#--------Xt-------X-
XXXX------XXX-g-X----X#-X-------------X--X------X-X----X---X-g-X---X-------X--X--X-#X------X-T-XX----X-T---X-----T---XT--X----X#X--------------T--X-X-
XXXX-----X#----X----T------X--X-XXXS--XX--------X---X------T----------K---------#---!S-XX--S-XXTX---X-----T--X-X--X---------S-----X--------X-#X--X---X
