------X---X-X-X-----U--XXX--X--T--XX--X--X------XX-X-------g-t---X--------XX-----S---X--X--X----X-----------X----X----------XX--S--X---S--XXXXX---X---
------XXg--------T---X---X--X--------------XX--X--X-!X------X-----X------------g----X-X-X-----X-g-------S-S--TS------------!TX-X------X-----S-X-X-----
---------XXX----T-----X---------X---T--X-X#---1-------X---------X-----#X-X-----#X-X----------X--X------X--X-------X------XX--X-XT-------------------T-
----------X--T--X--#--X-X---X-S-----XXSS---XX#---X!X#---XX-----XX-X--XX-X----T-------X-----X-X-------XXXX-U---------X--XX---X-X-X------X------TXXX----
---------CX--X#XX----X-Xt-X---XX---X-------XX---XX-X----------S-Xg----X#X-----X-SS-------X--XXXX-------XS---X-----X-------X-k--X---!---X-----------X--
--------g--#-----X-X!X-----------S---X--------X-X------S---X-TX---X-XX--X-----XX-X-----S--------S--------TX-S----T-----X--XX------XS---XgX------S----X
-----X#----X--X--X----XX---X--X---X--XXX--X--X-XX--T-!---S-X-X-----TXX--X-X-----X---X-X--X-T-X-------X----!-T-X-X-S-----#---X-X--S----T-----X--X--XX--
------------tX---XX---X-X-X--X-X--kX-S-X---X-X--------#--X--T--XX----S----X--X---X-XX-------X-------t---X-----T--------X-----------t-----#---------XXT
-----XXX-------X-----------X---X---T----XX----Xg-------X---------X----X-@--t--XX--X----S----------X--Tt----X----XX-S-T------------g-X---X-X--X----T---
----------g---------------T-XXXX--X-----------X-X--S--XX-X---X------X------T-X--X--S---X----X------S--X--------t-----XT-X-X----X--X--X----X---XX-#C---
------TX---TX--------X-----------X------XS------X--X--S--X-X-------X---XS-------X-#----X-----------X---X---XS-C----!XXXT-----X---X--X---T--------T-X-X
---------------X--XXXX-k---X--X--------------X----X---X--X---X-X-X---X--X--XU---X-XX-#--X-XT-----XX--S-XX-X-------------gX---@-X-------XXX------XX-X-X
----X-------X-XX---X--------X------XX---X--------------XT-X---#-------X-S---X----S--X----X---X--C-----X---X---------X---XX--X-X--T-!---X---XX---t-----
------X--X--X----------XX--X--XXX-X-X-----XX---#-SX-X--S----------XX-----------T-!--T------#t---------SX--X----X---TX---XX-XXX---X----t----------T----
XXXXX--X-----X--X----!---------------XX----tX-----X-X-----X-T-X-g----X--#g----XX-----X-SX----X-------------#--XX---X-------X-X--X-X-X----SX-T----#--X-
XXXX----X--X-X--XX--X---!T-X----XS-X-X-----------T-------------X-#----------X--------X---X-----XXX--XXX----X--X-----X---------X-T-X-------X----S------
