-------------------------------------------------------------------------------------------------------------------------------------------------------------------------------------------------
-------------------------------------------------------------------------------------------------------------------------------------------------------------------------------------------------
-------------------------------------------------------------------------------------------------------------------------------------------------------------------------------------------------
-------------------------------------------------------------------------------------------------------------------------------------------------------------------------------------------------
-------------------------------------------------------------------------------------------------------------------------------------------------------------------------------------------------
-------------------------------------------------------------------------------------------------------------------------------------------------------------------------------------------------
------------------------------------------------------------------------!!!!!-----------!-SSSS---------------------SSS----S!!S--------------------------------------------------------##---------
-------------------------------------------------------------------------------------------------------------------------------------------------------------------------------------###---------
------------------------------------------------------------------------------------------------------------------------------------------------------------------------------------####---------
--------------------------------------------------------------------------k--------------------------------------------------------------------------------------------------------#####---------
-----------------------------------------------------------------TT-----@!!!!----------S---------------!!!!-----S----------SS------#--#----------##--#------------SS!S------------######---------
-------K--------------------TT-----TT----K-----------------------TT---------------------------------------------------------------##--##--------###--##--------------------------#######---------
----------------------------TT-----TT----------------------------TT---------------------------------B----------------------------###--###------####--###-----tt--------------tt-########--------F
--M-----------ggg---------kkTT-----TT-----------ggg-------ggg----TT------------gg----k-gg-----------b-----------------gg-g-g----####--####----#####--####----tt---------gg---tt#########--------#
XXXXXXXXXXXXXXXXXXXXXXXXXXXXXXXXX--XXXXXXXXXXXXXXXXXXXXXXXXXXXXXXXXXXXXXXXXXXXXXXXXXXXXXXXXXXXXXXXXXXXXXXXXXXXXXXXXXXXXXXXXXXXXXXXXXXXXXXXXXXXXXXXX--XXXXXXXXXXXXXXXXXXXXXXXXXXXXXXXXXXXXXXXXXXXX
XXXXXXXXXXXXXXXXXXXXXXXXXXXXXXXXX--XXXXXXXXXXXXXXXXXXXXXXXXXXXXXXXXXXXXXXXXXXXXXXXXXXXXXXXXXXXXXXXXXXXXXXXXXXXXXXXXXXXXXXXXXXXXXXXXXXXXXXXXXXXXXXXX--XXXXXXXXXXXXXXXXXXXXXXXXXXXXXXXXXXXXXXXXXXXX
