--------------------------------------------------------------------------------------------------------------------------------
--------------------------------------------------------------------------------------------------------------------------------
--------------------------------------------------------------------------------------------------------------------------------
--------------------------------------------------------------------------------------------------------------------------------
--------------------------------------------------------------------------------------------------------------------------------
--------------------------------------------------------------------------------------------------------------------------------
---------------------L!!----------!!!!!!!!-----------USSS--------SSCSS------SSSS-------------------------------------##---------
--------------------------------------------------------------------------------------------------------------------###---------
-----------------g-------------------------------------------------------------------------------------------------####---------
-----------------#---------------------k-----------------------------------------------g--------------------------#####---------
--------SUS-----##---2SS----------@!!!!!!!----------S-----TT---!!!!--!!!---------------TT------------------------######---------
---------------###----------------------------------------TT---------------------------TT-----------------------#######---------
--------------####----------------------------------------TT---------------------------TT-------------TT-------########--------F
--M----------#####----g---g-gk--------------gg----k-ggg---TT------------ggg------------TT----------r--TT----g-#########--------#
XXXXXXXXXXXXXXXXXXXXXXXXXXXXXXXXXXXXXXXXXXXXXXXXXXXXXXXXXXXXXXXXXXXXXXXXXXXX----XXXXXXXXXX---XXXXXXXXXXXXXXXXXXXXXXXXXXXXXXXXXXX
XXXXXXXXXXXXXXXXXXXXXXXXXXXXXXXXXXXXXXXXXXXXXXXXXXXXXXXXXXXXXXXXXXXXXXXXXXXX----XXXXXXXXXX---XXXXXXXXXXXXXXXXXXXXXXXXXXXXXXXXXXX
