---------------------------------------------------------------------------------------------------------------------------------------------------------------------------------------------------------------------------------------------------------------------
---------------------------------------------------------------------------------------------------------------------------------------------------------------------------------------------------------------------------------------------------------------------
---------------------------------------------------------------------------------------------------------------------------------------------------------------------------------------------------------------------------------------------------------------------
---------------------------------------------------------------------------------------------------------------------------------------------------------------------------------------------------------------------------------------------------------------------
---------------------------------------------------------------------------------------------------------------------------------------------------------------------------------------------------------------------------------------------------------------------
------------------------------------------------------------------------------------------------------------------------------------------------------------r--------------------------------------------------------------------------------------------------------
-----------------------------US-------------------------------------------------SSSSSSS---SSS!--------------@-----------SSS----S!!S--------------------SSSSSSSSS------------------------------------------------------------------------------------------##---------
-----------------------------------------------------------------------------------------------------------------------------------------------------------------------------------------------------SSSSSS----------------TT----------------------------###---------
---------------------------------------------------------------------oo--------g-------------------------------------------------------------------------------------------------------------------K-----------------------TT---------------------------####---------
-----------------------------------------------------------------y-----------------------------------------------------------------------------------------k-k----#---------------------------------------------------k----TT--------------------------#####---------
---------!!-----------------####--SSC------------------ooo-------##----------S@S-------------C-----SU----!--!--!-----S----------SS------#--#----------TT---CCCCCCC#--------------------------------TT---tt------------TT--CCC@------------------------######---------
-----------------------y-#####----------------------------------###--------------------------------------------------------------------##--##--------#TT-------------------------------------------TT---tt------------TT-----------------------------#######---------
--------------------y-######-----------------------------------####-------------------------------------------------------------------###--###------##TT-------------------------------------------TT---tt------------TT-------------------TT-------########--------F
--M----------------#######------------------y-y---------------#####---------------------------g-g--------k-----------------gg-g-g----####--####----###TT----kk------------gg-------------kkk-------TT---tt------------TT-----r----------r--TT----g-#########--------#
XXXXXXXXXXXXX--XXXXXXXXX------XX--XXXXXXXXXXXXXXXX--XXXXXXXXXXXXXXX---XXXXXXXXXXXXXXX---XXXXXXXXXXXXXXXXXXXXXXXXXXXXXXXXXXXXXXXXXXXXXXXXXXXXXXXXXXXXXXXXXXXXXXXXXXXXXXXXXXXXXXXXXXXXXXXXXXXXXXXXXXXXX---XX--XXXXXXXXXXXXXXXXXXX---XXXXXXXXXXXXXXXXXXXXXXXXXXXXXXXXXXX
XXXXXXXXXXXXX--XXXXXXXXX------XX--XXXXXXXXXXXXXXXX--XXXXXXXXXXXXXXX---XXXXXXXXXXXXXXX---XXXXXXXXXXXXXXXXXXXXXXXXXXXXXXXXXXXXXXXXXXXXXXXXXXXXXXXXXXXXXXXXXXXXXXXXXXXXXXXXXXXXXXXXXXXXXXXXXXXXXXXXXXXXX---XX--XXXXXXXXXXXXXXXXXXX---XXXXXXXXXXXXXXXXXXXXXXXXXXXXXXXXXXX
