----------------------------------------------------------------------------------------------------------------------------------------------------------------------------------------------------------------------------------------------------------------------------------------------------------------------------------------------------------------------------------------------------------------
----------------------------------------------------------------------------------------------------------------------------------------------------------------------------------------------------------------------------------------------------------------------------------------------------------------------------------------------------------------------------------------------------------------
----------------------------------------------------------------------------------------------------------------------------------------------------------------------------------------------------------------------------------------------------------------------------------------------------------------------------------------------------------------------------------------------------------------
------------------------------------------------------------------g--------------------------------------------------------------g------------------------------------------------------------------------------------------------------------------------------------------------------------------------------------------------------------------------------------------------------------------------------
----------------------------------------------------------------------------------------------------------------------------------------------------------------------------------------------------------------------------------------------------------------------------------------------------------------------------------------------------------------------------------------------------------------
-----------------------------------------------------------------------------------------g-----------------------------------------------------------------------------------------------------------------------------------------------------------------------g----K------------------------------------ggg-gr----------------------------------------------------------------------------g-------------g----
------------------------------------------------------------------------------------------------------------------------!-!-------------------------1-------------------!-!-------------------------1------S------------!-!-----------------------------------------SSSSSSS@----------------------------SCSSSSSSSSSS-------------------------------------------------------!!!!!-----------USSS--------SSCSS----
------------------------------------------------------------------@------------------------------------------------------------------------------------------------------------------------------------------------------------------------------------------------------------------------------------------------------------------------gS-------------------------------------------------------------------
---------------------------------------------------------------------------------------------------------------------------------------------------------------------------------------------------------------------------------------------------------------------------------------------------------------------------------------------g--------------------------------g---------------------------------
-------------------------o-----------------------k----------------------------------------------oooo--------------------------------------------------------------------------------------------------------------------k------------------------------------------------K-------------------------------------k-k----#------------------------------------------------------k-k--------------g-----------------
-----SSS------TT---------------------------------------------ooo---------------------ooo-----------o----!-S-------------!-!------------------------!!!------------------!-!------------------------!!!------------------!-!-----------------------------------------SSSSSSSS-----------------------------!------CCCCCC#--------------------------------------------o-T-----@!!!!----------S-----TT---!!!!--!!!--
--------------TT----TT--------------------------------------------#--------------------------------------------------------------------------------------------------------------------------------------------------------------------------------K---------------------------#------------------SSS---------------------------------------------------------------TT--------------------------TT--------------
--------------TT----TT--------------------------------------------#--------K-------------------------------------------------------------------------------------------------------------------------------------------------------------------------B-----------TT------------#------------C@----------------------------------------------------------------------TT--------------------------TT--------------
--M----------gTT---kTT-----gkk---kkk---kkk---k-kgkk----g----------#-------------k-kkk----kk-------------------y--------k----y-----g------------gg-gyy---k-k---y-------------y------k-k-------------gy---------y------gg-k---y---------------------g--b-ggg----kggTT------kg----#----yyy-------------------------kk------------ggg---T--g-----kkk-------kkk---#-----gTT---g--------gg----kgggg---Tg------------gg
XXXXXXXXXXXXXXXXXXXXXXXXXXXXXXXXXXXXXXXXXXXXXXXXXXXXXXXXXXXXXXXXXXXXXXX-X-XgXXXXXXXXXXXXXXXXXXXXXXXXXXXXXXXXXXXXXXXXXXXXXXXXXXXXXXXXXX----XXXXXXXXXXXXXXXXXXXXXXXXXXXXXXXXXXXXXXXXXXXX----XXXXXXXXXXXXXXXXXXXXXXXXXXXXXXXXXXXXXXXXXXXX----XXXXXXXXXXXXXXXXXXXXXXXXXXXXXXXXXXX--XXXXXXXXXXXXXXXX-------XXXXXXXXXXXXXXXXXXXXXXXXXXXXXXXXXXXXXXXXXXXXXgXXXXXXXXXXXXXXXXXXXXXXXXXXXXXXXXXXXXXXXXXXXXXXXXXXXXXXXXXXXX
XXXXXXXXXXXXXXXXXXXXXXXXXXXXXXXXXXXXXXXXXXXXXXXXXXXXXXXXXXXXXXXXXXXXXXXXX-X-XXXXXXXXXXXXXXXXXXXXXXXXXXXXXXXXXXXXXXXXXXXXXXXXXXXXXXXXXX----XXXXXXXXXXXXXXXXXXXXXXXXXXXXXXXXXXXXXXXXXXXX----XXXXXXXXXXXXXXXXXXXXXXXXXXXXXXXXXXXXXXXXXXXX----XXXXXXXXXXXXXXXXXXXXXXXXXXXXXXXXXXX--XXXXXXXXXXXXXXXX-------XXXXXXXXXXXXXXXXXXXXXXXXXXXXXXXXXXXXXXXXXXXXXXXXXXXXXXXXXXXXXXXXXXXXXXXXXXXXXXXXXXXXXXXXXXXXXXXXXXXXXXXXXX
