--------------------------------------------------------------------------------------------------------------------------------------------------
--------------------------------------------------------------------------------------------------------------------------------------------------
--------------------------------------------------------------------------------------------------------------------------------------------------
--------------------------------------------------------------------------------------------------------------------------------------------------
--------------------------------------------------------------------------------------------------------------------------------------------------
--------------------------------------------------------------g-----------------------------------------------------------------------------------
------------------SCS-----------------------------------------SSSSS-----SSSSS----------------------------------------------------------##---------
---------------------------TT----------------------------------------------------------------------------------------------------------##---------
---------------------------TT----------------------------TT-----------------------TT-------------------------------------------------#-##---------
---------------------------XX----------------------TT----TT-----------------------TT-------------------------------------------------#-##---------
-----SSS------TT---2---TT----------------TT---SU---TT----XX------------------2----TT-------------tt--------------------------------#-#-##---------
--------------TT-------TT-------------K--TT--------TT----------------------TT-----TT-----TT------tt--------------TT----------------#-#-##---------
--------------TT-------TT-----TTTT-------TT--------TT---------TT-----tt----TT--TT-TT-----TT------tt-T------------TT---------TT---#-#-#-##--------F
--M-----------TT----k--TT-----TTTT-------TT------k-TT---------TT-----tt----TT--TT-TT---k-TT------tt-T------kkk---TT---------TT---#-#-#-##--------#
XXXXXXXXXXXXXXXXXXXXXXXXXXXXXXXXXXXXXXXXXXXXXXXXXXXXXXXXXXXXXXXXXXXXXXXXXXXXXXXXXXXXXXXXXXXXXXXXXXXXXXXXXXXXXXXXXXXXXXXXXXXXXXX-X-X-X-XXXXXXXXXXXX
XXXXXXXXXXXXXXXXXXXXXXXXXXXXXXXXXXXXXXXXXXXXXXXXXXXXXXXXXXXXXXXXXXXXXXXXXXXXXXXXXXXXXXXXXXXXXXXXXXXXXXXXXXXXXXXXXXXXXXXXXXXXXXX-X-X-X-XXXXXXXXXXXX
