----------------------------------------------------------------------------------------------------------------------------------------------------------------------------------------------------------------------------------------------------------
----------------------------------------------------------------------------------------------------------------------------------------------------------------------------------------------------------------------------------------------------------
----------------------------------------------------------------------------------------------------------------------------------------------------------------------------------------------------------------------------------------------------------
----------------------------------------------------------------------------------------------------------------------------------------------------------------------------------------------------------------------------------------------------------
----------------------------------------------------------------------------------------------------------------------------------------------------------------------------------------------------------------------------------------------------------
-------------------------------------------------------------------------------------------------------------------------------K--------------------------------------------------------------------k-----------------------------------------------------
---------------------LSSS---------------------!!!!!-----------USSS-----------------------------------SSSSS---@-------------SSSSSS----1----------------------------------------SSSSS----------------S!S--S!S-----------------------------------g##---------
---------------------------------------------------------------------------------------------------------------------------------------------------------------------------------------------------------------------------------------------g###---------
-----------------g-----------------------------------------------------------------------------------------------------------------------------------------------------------------------g#-------------------------------------------------g####---------
-----------------#------------------------------k---------------------------------------------------------------------------K--------------------------------------------------K--------g##-------------------------------------------------#####---------
--------SUS-----##---2-----#-----------TT-----@!!!!----------S-----TT-----------------------------C--------!--------------SSSSSSS---------------------------------------------SSSSS-----###--------S!S--S@S----------------------------##--######---------
---------------###---------#-----------TT--------------------------TT----------------------#---------------------TT------------------TT--------------TT--------------------------K-----####--------------------------------------------##########---------
--------------####---------##----------TT--------------------------TT------------------K---#---------------------TT------------------TT---------B----TT----TT-----B-----TT------------#####------------------------#---#---------------##########--------F
--M----------#####----kk---##---gg-----TT------------gg----k-ggg---TT-----k----------------#-----gg-------K-K----TT------------------TT---------b----TT-k--TT-----b-----TT-----------######------k------ggg--------#-k-#---------------##########--------#
XXXXXXXXXXXXXXXXXXXXXXXXXXXXXXXXXXXXXXXXXXXXXXXXXXXXXXXXXXXXXXXXXXXXXXXXXXXX---XXXXXXXXXX--XXXXXXXXXXXXXXXXXXXXXXXXXXXXXXXXXXXXXXXXXXXXXXXXXXXXXXXXXXXXXXXXXXXXXXXXXXXXXXXXXXXXXXXXXXXXXXXX--XXXXXXXXXXXXXXXXXXXXXXXXXXXXXXXXXXXXXX----XXXXXXXXXXXXXXXXXXX
XXXXXXXXXXXXXXXXXXXXXXXXXXXXXXXXXXXXXXXXXXXXXXXXXXXXXXXXXXXXXXXXXXXXXXXXXXXX---XXXXXXXXXX--XXXXXXXXXXXXXXXXXXXXXXXXXXXXXXXXXXXXXXXXXXXXXXXXXXXXXXXXXXXXXXXXXXXXXXXXXXXXXXXXXXXXXXXXXXXXXXXX--XXXXXXXXXXXXXXXXXXXXXXXXXXXXXXXXXXXXXX----XXXXXXXXXXXXXXXXXXX
