----------------------------------------------------------------------------------------------------------------------------------------------------------------------------------------------------------------------------------------------------------------------------------------------------------------------------------------------------------------------------------------------------------------
----------------------------------------------------------------------------------------------------------------------------------------------------------------------------------------------------------------------------------------------------------------------------------------------------------------------------------------------------------------------------------------------------------------
----------------------------------------------------------------------------------------------------------------------------------------------------------------------------------------------------------------------------------------------------------------------------------------------------------------------------------------------------------------------------------------------------------------
----------------------------------------------------------------------------------------------------------------------------------------------------------------------------------------------------------------------------------------------------------------------------------------------------------------------------------------------------------------------------------------------------------------
----------------------------------------------------------------------------------------------------------------------------------------------------------------------------------------------------------------------------------------------------------------------------------------------------------------------------------------------------------------------------------------------------------------
-------------------------------------------------------------------------------------------------------------------------------------------------------------------------------------------------------------oo-------------------------------------------------------------------------------------------------------------------------------------------------------------------------------------g-----------
---------------------LSSS----------------------------------------------------------------------------------------------------------------------------------------------------------------------SUS--------------------------------------------------------------------------------------------------------------------------------------------------------------------------------------------------SSSSS-----SS
----------------------------------------------------------------------------------------------------------------------------------------------------------------------------------------------------------------------------------------------------------------------------------------------------------------------------------------------------------------------------------------------------------------
-----------------g-------------------------------------------------------------------------------------------------TT--------------------------------------------------------------------------------o---------------------------------------------------------------------------------------B-------------------------------------------------------------------------------------------------TT---------------
-----------------#-----------------------------------------------------------------------o-------------------------TT----------------------------------------------------------------------------------------------------------------------o--------------S-oo---------------------tt--------b-------------------------------------B-----------------------------------------------------TT----TT---------------
--------SUS-----##---2-----#------------------------------------------------------------------------------#LSS-----##-------------------------------------------------------------------------#####----------------------------------------------------------------------------TT--tt------SS#CS---------------S@---------SS------S#2------------------------------------------TT---SU---TT----KX---------------
---------------###---------#-----B----------------------------TT------------------------------------------#---------------------------------------------------TT---------K--------------------#---------#------------------------------------------------------------------TT--TT--tt--------------------B-------------------------------B----------------------------TT-------TT--------TT---------------------
--------------####---------##----b-----TT---------TT----------TT-----TT-----K-----------------------------#-----------B---TT-----B-----TT---------TT----------TT-----TT-----K----------------K#--------------------------------------K---------#---------------------------TT--TT--tt----------K-B-----K-bK----------B-------------------b-----TT----K----TT----------TT-------TT--------TT---------TT-----tt---
--M----------#####----kk---##----------TT----#----TT----------TT-----TT--------ggg---------gg------------k#-----------b---TT-----b----TTT---------TT----------TT---g-TT--------ggg---------g--#------------k-----S-----------kgg-------------k-#--y-------------------ggg--TT--TT--tt------------b-------------------b--y------B--y-y---gb-----TT---------TT----------TT-------TT------k-TT---------TT-----tt---
XXXXXXXXXXXXXXXXXXXXXXXXXXXXXXXXXXXXXXXXXXXXXX-XXXXX-X------XXXXXXXXXXXXXXXXXXXXXXXXXXXXXXXXXXXXXXXXXXXXXXXXXXX---XXXXXXXXXXXXXXXXXXXXXXXXXXXX-XXXXX-X------XXXXXXXXXXXXXXXXXXXXXXXXXXXXXXXXXXXXX----XXXXXXXXXXXXX---XXXXXXXXXXXX-X-X-XXXXXXXXXXXXXXXXXXX------XXXXXXXXXX-XX--XX--XXXXXXXXXXXXXXXXXXXXXXXXXXXXXXXXXXXXXXXXXXXXXXXXXXXXXXXXXXXXXXXXXXXX-XXXXX-X------XXXXXXXXXXXXXXXXXXXXXXXXXXXXXXXXXXXXXXXXXXXX
XXXXXXXXXXXXXXXXXXXXXXXXXXXXXXXXXXXXXXXXXXXXXX-XXXXX-X------XXXXXXXXXXXXXXXXXXXXXXXXXXXXXXXXXXXXXXXXXXXXXXXXXXX---XXXXXXXXXXXXXXXXXXXXXXXXXXXX-XXXXX-X------XXXXXXXXXXXXXXXXXXXXXXXXXXXXXXXXXXXXX----XXXXXXXXXXXXX---XXXXXXXXXXXX---X-XXXXXXXXXXXXXXXXXXX------XXXXXXXXXX-XX--XX--XXXXXXXXXXXXXXXXXXXXXXXXXXXXXXXXXXXXXXXXXXXXXXXXXXXXXXXXXXXXXXXXXXXX-XXXXX-X------XXXXXXXXXXXXXXXXXXXXXXXXXXXXXXXXXXXXXXXXXXXX
