-----------------------------------------------------------------------------------------------------------------------------------------------------------------------------------
-----------------------------------------------------------------------------------------------------------------------------------------------------------------------------------
-----------------------------------------------------------k-----------------------------------r-----------------------------------------------------------------------------------
----------------------SSSSSSSSSSSSSSSSSSSSSSSSSSSSSSSSS-SSSSSS-------SSSS-----SSSSSSSSSSSSSSSSSSSSSSSSSSSSSSS-----SSSSSSSSSSSSSSSSSSSSSSSSSSSSSSSSSSSSSSSSSSSSSSSSSSSSSSSSSSSSSSSS-
------------------------------------------------------------------------------------------------------------------SSSSSSSSSSSSSSSS-SSSSSSSSSSSSSSSSSSSSSS-SSSSSSSSSSS-SS-----------
------------------------------------------------------------------------------------------------------------------SSSSSSSSSSSSSSSS-SSSSSSSSSSSSSSSSSSSSSS-SSSSSSSSSSS-SS-----------
------------------SCS------------------------------------------------SUS------------------------------------------SSSSSSSSSSSSSSSS-SSSSSSSSSSSSSSSSSSSSSS-SSSSSSSSSSS-SS-S---------
--------------------------------TT-------------------------------------------------------TT-----------------------S---------------------------------------------------------TT-----
--------------------------------TT---------------------k---------SSS------SSS------------TT-----------------------S--------------------------------------------------U------TT-----
--------------k-----------------TT-------------------------------------k-----------------TT-------------------------oooooooooo------ooooooooooooooooo------oooooSooooo------TT-----
-----SSS------TT---2----------SCTTSU------TT-------------TT----------SSSS--------------SCTTSU----------------------USSSSSSSSSS----#--SSSSSSSSSSSSSSSS----#-SSSSSSSSSSS--#---TT----F
--------------TT----------TT----TT----TT--TT----------#--TT--##--------------------------TT----TT-----------#--------------------##k--------------------##-------------##kk-TT---SS
--------------TT----------TT----TT----TT--TT--------###--TT--##------------------tt------TT----TT----------##-SSS---------------###--------------------###------------###---TT---SS
--M---------k-TT----k-----TT-r-kTT---kTT--TT--------###--#k--##-----------------kttk---kkTT---kgT----r----###-----------k-kk--k####-k---kkkk-k-kkkkk-k####k----kkk--kk###--kkT---Sk
XXXXXXXXXXXXXXXXXXXXXXXXXXXXXXXXXXXXXXXrXXXX--XXXXXXXXX--XX--XX------XXXX------XXXXXXXXXXXXXXXXXXX--XXXXXXXXX-----XXXXXXXXXXXXXXXXXXXXXXXXXXXXXXXXXrXXXXXXXXXXXXXXXXXXXXXXXXXXX--XX
XXXXXXXXXXXXXXXXXXXXXXXXXXXXXXXXXXXXXXXXXXXX--XXXXXXXXX--XX--XX------XXXX------XXXXXXXXXXXXXXXXXXXX-XXXXXXXXX---r-XXXXXXXXXXXXXXXXXXXXXXXXXXXXXXXXXXXXXXXXXXXXXXXXXXXXXXXXXXXXX--XX
