-----------------XXXXX--XXXXXXXXXXXXXX--XXXXXXXTX----------------------r-r-----------------r---------------------------------------------------------------r-------r----
------------------XXXX--XXXXXXXXXXXXXX--XXXXXXX------------------------r-----------------r--------------r---------------------------------------------------------------
-----------r-------------------------------------------------------------------------------1-------r-r--------------------------------r---------------------------r-----
-----------------------------------------------------------------------------r----------------r----------------------------------------------r----------r---------------
-------------------------------r--------------------r-----------------------------r-------------------------------------------r-----------------------------------------
---------r---------S-------------------------------------------##--------------------------g--------------------------------2-------------------------------------------
--------------------r--r--------------------------------------###--------------r---------r##-------------------------------------------------------------r--------------
-----S---r--------r-r-------------------r--------------------####-------------------------------------------r----------------------------------------------------------F
--------SS----o----SU------------------r----r---------------#####-------r----rr--rg-----r------------------------------------2-----------------X-XX--------------------#
------------------r----------------------------------------######------rXXXXXXX--XXXXggg-----r-----------@---------------------------------XXXXX-XXr--r--r---------rXXXX
----------SS---SS-S--r--------#---------------------------#######-----XXXXXXXXX--XXXXXXXX------------------------------#---------r----gg-X-XXXX------XXXXXXX-XX-XX-XXXXX
------------S-S--------------##--oo----------------------########----XXX-------------XXXX------------Xr-----------B----#-------XXXXXXXXXXXr----------XXXXXXX-XX-XX-X----
----r--------------SC-r-----###--------------r--------g-#########----X--------------------------XXXX-X-X-r-r---r--b----#---r---XXXXXXXXXX------r------------------------
--M---r--------------------g###----------------------XXXXXXXXXXXXXXXX------r------r-------------XXXX---X-XX---XXXXXXX--XXXXXXXX------------r----------------------------
XXXXXXX--------------------####-----------------g-XXXXXXXXXXXXXXXXXXX----------r-----r-------------------XX---XXXXXXX--XXXXXXXX----------r-------------r----------------
XXXXXXXr----------Xr-r----#####--k--------r--r-gTXXXX----------------r--------------------------------------------------r------r----------r-----------------------------
