------------------------------------------------------------------------------------------------------------------------------------------------------------------------------------------------------------------
------------------------------------------------------------------------------------------------------------------------------------------------------------------------------------------------------------------
------------------------------------------------------------------------------------------------------------------------------------------------------------------------------------------------------------------
---------------------------------------------------------------------------------------------------------------oo----------------------------------------------------------------------------------oo-------------
---------------------------------------------------------------------------------------------------------------------g--------------------------------------------------------------------------------------------
------------------------------------------------------------------------------------oo---%%%%--------------------%%%%%-------------oooo---------------------------------oo---%%%%--------------------%%%%---------
---------------SSS-----------------SSS-----------------SSS-----------------SSS------SS----||--------------SSS-----|||--------------%%%%------------------------SSS------SS----||--------------SSS-----||----------
------------------------------------------------------------------------------------------||------SSS-oo----------|||----oo---------||----------------------------------------||------SSS-oo----------||----------
------------------------------------------------------------------------------------------||----------------------|||---------------||-------oooo-----------------------------||----------------------||----------
----%%%%%%--------------%%%%%%--------------%%%%%%--------------%%%%%%-----------------SS-||%%%%%-----SS----------|||---------SSS---||--------------%%%%%%-----------------SS-||%%%%%-----SS----------||----------
-----||||----------------||||----------------||||----------------||||---------------------||-|||------------------|||---------------||---------------||||---------------------||-|||------------------||----------
-----||||----------------||||----------------||||----------------||||---------------------||-|||------------------|||-------------U-||---------------||||---------------------||-|||------------------||---------F
--M--||||----------------||||----------------||||----------------||||---------------------||-|||------------------|||---------------||---------------||||---------------------||-|||------------------||---------X
%%%%-||||-%%%%%%----%%%%-||||-%%%%%%----%%%%-||||-%%%%%%----%%%%-||||-%%%%%%----%%%%-----%%%%|||------------------|||---------------||------%%%-%%%%-||||-%%%%%%----%%%%-----%%%%|||------------------||-XXXXXXXXX
-||--||||--||||------||--||||--||||------||--||||--||||------||--||||--||||------||-------||-|||------------------|||----%%%%-----%%%%%-%%%%||---||--||||--||||------||-------||-|||------------------||-XXXXXXXXX
-||-----------------------------------------------------------------------------------------------------------------------||-------|||---|||----------------------------------------------------------------------
