--------------------------------------------------------------------------------------------------------------------------------------------------------------------------------------------------
--------------------------------------------------------------------------------------------------------------------------------------------------------------------------------------------------
--------------------------------------------------------------------------------------------------------------------------------------------------------------------------------------------------
--------------------------------------------------------------------------------------------------------------------------------------------------------------------------------------------------
---------------------------------------------------------------------------------------------------------------------------------------------------------------------------------------XX---------
---------------------------------------------------------------------------------------------------------------------------------------------------------------------------------------XX---------
---------------------LSSS---------------------!!!!!-----------USSS--------SSCSS------SSSS-----------------------------USSS-----------------------------------SSSSS---@-------------C---XX---------
---------------------------------------------------------------------------------------------------------------------------------------------------------------------------------------XX---------
-----------------g---------------------------------------------------------------------------------------------------------------------------------------------------------------------XX---------
-----------------#------------------------------k-----------------------------------------------g--------------------------TT----------------------------------------------------------XX---------
--------SUS-----##---2-----#-----------TT-----@!!!!----------S-----TT---!!!!--!!!---------------TT-----------------TT------TT-----------------------------C--------!--------------SS---XX---------
---------------###---------#-----------TT--------------------------TT---------------------------TT----------g------TT--tt--TT----------------------#---------------------TT------------XX---------
--------------####---------##----------TT--------------------------TT---------------------------TT----------TT-----TT--tt--TT------------------K---#---------------------TT------------XX--------F
--M----------#####----kk---##---gg-----TT------------gg----k-ggg---TT------------ggg------------TT----------TT--g--TT--tt--TT-----k----------------#-----gg-------K-K----TT--------k---XX--------X
XXXXXXXXXXXXXXXXXXXXXXXXXXXXXXXXXXXXXXXXXXXXXXXXXXXXXXXXXXXXXXXXXXXXXXXXXXXXXXXXXXXXX----XXXXXXXXXX---XXXXXXXXXXXXXXXXXXXXXXXXXXXXXX---XXXXXXXXXX--XXXXXXXXXXXXXXXXXXXXXXXXXXXXXXXXXXXXXXXXXXXXXXX
XXXXXXXXXXXXXXXXXXXXXXXXXXXXXXXXXXXXXXXXXXXXXXXXXXXXXXXXXXXXXXXXXXXXXXXXXXXXXXXXXXXXX----XXXXXXXXXX---XXXXXXXXXXXXXXXXXXXXXXXXXXXXXX---XXXXXXXXXX--XXXXXXXXXXXXXXXXXXXXXXXXXXXXXXXXXXXXXXXXXXXXXXX
