------------------------------------------------L------------------------------------Y-#------XXXXX--XX-X--CXX-#-X------------------------------------
------------------------------------------------------------------------------------#XXXr-X!X--XXXXX-XX!-X------------------------!------------------T
-----------------------------------S-----------------------------X-----------XXX-!-XkX-X-X-X---X------------------------------------------------------
----------------------S------------S--------------------------#---g-X---T-XXX#t-XXXXtXXXX-X---X---X------------------------------------------------#X-
------k----------------T---------------STS-----#-------------X--g-T--Xg-XXXX-XX!X#X---XX----------------------------------------#-t---------------T---
-------------------S------------------#------T----------#--------X#-X-X-XXX--XX-----X---------------------------------------------------XS-------T--XX
--------------g--------F----T----------------!--------#T-----T#XX-#--XX-----XX-K---------------------------------------------------S------g-X-X-#X-X-X
------g----LT------------#--gS-------------S---S-#--RtL---X-X-XXXX#X--------#--------------------------------------------------#---#t-T-SX#YTX-X-XXXXX
-----X-----t----------!##---T--------Sk--#----XSXX##XXXX#XXXXXXX-X-------------------------T---T--------X-------------------------g--XXXXXXX#-XXX-XXX-
------------S-----#-X#---X-#--#----X#1#--X##t-XXXXXXX#XXXX-X-XT------------------------------------------------------#--X-----#X#XXXXtXXXXXXX---------
---------S-#TT-t!C---XX-XXXX-XXXX-#X---XXXXXXX-XX-X-XX---Xt--------------------------------------------------------------t-T-XtXXXX-X-X-----X---------
-----------X-#-#-XTXXXXXXXXXXXX-XX-XXXXX--XXX@XX-X----------------------------------------------------------F----X-X---#-#XXXXXXXX#XXX--X---------#---
----T-#--XCXXXXXX#X--X-X--g----XXXX-X-----------------------------------------#----------F---S---TX---------S---#---X-#XXX--X--X----------------------
----1XXX-X-X-----#-------------------------------------------------------------------------!-t-t-----#-----S----t---XXX-XX---------X------------------
XXXXXXXX-XX----------------------!---------------------------------------------------------------t-X--X-Xg-t-#XXXX-XXX-X#------|-------------------S--
XXXX----X------------------------------------S--------------------------------g-#---------Tt--------XX-XX##X-tX-XXX------!----------------------------
