----------------------------------------------------------------------------------------------------------------------------------------------------------------------------------------------------------------------------------------------------------------------------------------------------------------------------------------------------------------------------------------------------------------
----------------------------------------------------------------------------------------------------------------------------------------------------------------------------------------------------------------------------------------------------------------------------------------------------------------------------------------------------------------------------------------------------------------
----------------------------------------------------------------------------------------------------------------------------------------------------------------------------------------------------------------------------------------------------------------------------------------------------------------------------------------------------------------------------------------------------------------
----------------------------------------------------------------------------------------------------------------------------------------------------------------------------------------------------------------------------------------------------------------------------------------------------------------------------------------------------------------------------------------------------------------
----------------------------------------------------------------------------------------------------------------------------------------------------------------------------------------------------------------------------------------------------------------------------------------------------------------------------------------------------------------------------------------------------------------
-------------------------------------------------------------------------------S--------------------------------------------------------------------------------------------------------------------------------------------------------------------------------------------------------------------------------------------------------------------------------------------------------------------------------
---------------------LSSS---------------------!!!!!-----------USSS--------SSCSS----------------------------------------------------------------SSSSCSSS---------------------------------------------------------------------------------------------------------------------------------------------------------------------------------------------------------------------------------------------------------
-------------------------------------------------------------------------------------------------------------------------------------------------------------------oooo----------oooo------------oooo------------oooo------------oooo------------oooo------------oooo------------oooo------------oooo------------oooo------------oooo------------oooo------------oooo------------oooo------------oooo-----------
-----------------g----------------------------------------------------------------------------------------------------------------------------------------------------------------------------------------------------------------------------------------------------------------------------------------------------------------------------------------------------------------------------------------------
-----------------#------------------------------k---------------------------------------------------------------------------------------------------------------------------------------------------------------------------------------------------------------------------------------------------------------------------------------------------------------------------------------------------------------
--------SUS-----##---2-----#-----------TT-----@!!!!----------S-----TT---!!!!--!S-#----------##--#---------------------------------------------#----2----#---------------------TT--------------TT--------------TT--------------TT--------------TT--------------TT--------------TT--------------TT--------------TT--------------TT--------------TT--------------TT--------------TT--------------TT----------------
---------------###---------#-----------TT--------------------------TT------------##--------###--##-------------------------------TT-----------#------K--#--------#------------TT--------------TT--------------TT--------------TT--------------TT--------------TT--------------TT--------------TT--------------TT--------------TT--------------TT--------------TT--------------TT--------------TT----------------
--------------####---------##----------TT--------------------------TT------------###------####--###-----tt-----------------------TT-----------#---------#--------#------------TT--------------TT--------------TT--------------TT--------------TT--------------TT--------------TT--------------TT--------------TT--------------TT--------------TT--------------TT--------------TT--------------TT----------------
--M----------#####----kk---##---gg-----TT------------gg----k-ggg---TT------------####----#####--####----tt-k----kkk---kkk--------TT------ggg--#---------#--------#---------y--TT---y------y---TT---y------y---TT---y------y---TT---y------y---TT---y------y---TT---y------y---TT---y------y---TT---y------y---TT---y------y---TT---y------y---TT---y------y---TT---y------y---TT---y------y---TT---y------------
XXXXXXXXXXXXXXXXXXXXXXXXXXXXXXXXXXXXXXXXXXXXXXXXXXXXXXXXXXXXXXXXXXXXXXXXXXXXXXXXXXXXXXXXXXXXXX--XXXXXXXXXXXXXXXXXXXXXXXXXXXXXXXXXXXXXXXXXXXXXXXXXXXXXXXXXXXXXXXXXXXXXXXXXXXXXXXXXXXXXXXXXXXXXXXXXXXXXXXXXXXXXXXXXXXXXXXXXXXXXXXXXXXXXXXXXXXXXXXXXXXXXXXXXXXXXXXXXXXXXXXXXXXXXXXXXXXXXXXXXXXXXXXXXXXXXXXXXXXXXXXXXXXXXXXXXXXXXXXXXXXXXXXXXXXXXXXXXXXXXXXXXXXXXXXXXXXXXXXXXXXXXXXXXXXXXXXXXXXXXXXXXXXXXXXXXXXXX---
XXXXXXXXXXXXXXXXXXXXXXXXXXXXXXXXXXXXXXXXXXXXXXXXXXXXXXXXXXXXXXXXXXXXXXXXXXXXXXXXXXXXXXXXXXXXXX--XXXXXXXXXXXXXXXXXXXXXXXXXXXXXXXXXXXXXXXXXXXXXXXXXXXXXXXXXXXXXXXXXXXXXXXXXXXXXXXXXXXXXXXXXXXXXXXXXXXXXXXXXXXXXXXXXXXXXXXXXXXXXXXXXXXXXXXXXXXXXXXXXXXXXXXXXXXXXXXXXXXXXXXXXXXXXXXXXXXXXXXXXXXXXXXXXXXXXXXXXXXXXXXXXXXXXXXXXXXXXXXXXXXXXXXXXXXXXXXXXXXXXXXXXXXXXXXXXXXXXXXXXXXXXXXXXXXXXXXXXXXXXXXXXXXXXXXXXXXXX---
