-----------------------------------------------------------------------------------------------------------------------------------------------------
-----------------------------------------------------------------------------------------------------------------------------------------------------
-----------------------------------------------------------------------------------------------------------------------------------------------------
-----------------------------------------------------------------------------------------------------------------------------------------------------
-----------------------------------------------------------------------------------------------------------------------------------------------------
----------------------------------------------------------------------r-------------------------------------------------------------------##---------
------------------SCS----------------------------------------------SSSSS--------------CCSS-----------------------------------------------###---------
---------------------------T------------------------------------------------------------------------------------------------------------####---------
---------------------------T-----------------------------------------------------------------------------------------------------------#####---------
---------------------------X------------------------------------------------------@------------------##--#------------SS!S------------######---------
-----SSS------TT---2---TT---------------g--------------------SSS---------------KK-------------------###--##--------------------------#######---------
--------------TT-------TT---------------TT-------B-----C@------------------------------TT-----------###--###-----tt--------------tt-########--------F
--------------TT-------TT---------------TT--g----b-------------------gg----------------TT----------####--####----tt---------gg---tt#########--------#
--M-----------TT----k--TT---------XXXXXXXXXXXXXXXXXXXXXXXX-------XXXXXXXXXXXXXXXXXXX---XX--XXXXXXXXXXXX--XXXXXXXXXXXXXXXXXXXXXXXXXXXXXXXXXXXXXXXXXXXX
XXXXXXXXXXXXXXXXXXXXXXXXXXXXXXX---XXXXXXXXXXXXXXXXXXXXXXXX-------XXXXXXXXXXXXXXXXXXX---XX--XXXXXXXXXXXX--XXXXXXXXXXXXXXXXXXXXXXXXXXXXXXXXXXXXXXXXXXXX
XXXXXXXXXXXXXXXXXXXXXXXXXXXXXXX----------------------------------------------------------------------------------------------------------------------
