--------------------------------------------------------------------------------------
--------------------------------------------------------------------------------------
--------------------------------------------------------------------------------------
--------------------------------------------------------------------------------------
--------------------------------------------------------------------------------------
--------------------------------------------------------------------------------------
------------------SCS------------------------------------------------------##---------
---------------------------TT---------------------------------------------###---------
---------------------------TT--------------------------------------------####---------
---------------------------XX-------------------------------------------#####---------
-----SSS------TT---2---TT----------------------------------------------######---------
--------------TT-------TT-------------K-------------------------------#######---------
--------------TT-------TT-----TTTT-----------------------------------########--------F
--M-----------TT----k--TT-----TTTT-----------ggg-------ggg------ggg-#########--------#
XXXXXXXXXXXXXXXXXXXXXXXXXXXXXXXXXXXXXXXXXXXXXXXXXXXXXXXXXXXXXXXXXXXXXXXXXXXXXXXXXXXXXX
XXXXXXXXXXXXXXXXXXXXXXXXXXXXXXXXXXXXXXXXXXXXXXXXXXXXXXXXXXXXXXXXXXXXXXXXXXXXXXXXXXXXXX
