-----------------------------------------------------------------------------o---------||--|||--------------------------------------------------------
---------------------------------------------------------------X---------------------------|||--------------------------------------------------------
---------------------------------------------------------------X------------------g--------|||--------------------------------------------------------
-------------------------------------------------------------------------------g-%%--------|||---------S--------S----------------------------------#--
-------------------------#------------------------------------S------------S---%-||%-------|||-----------------------------------------------------#--
-------------------------#----------------------------------------------------%|%||--------|||---------------------------------------------------#-#--
-------------------------#-----------------------------------------------------||||--------|||---------------------------------------------------###--
-------------------------#---1-------------------------------------------------||||--------|---o-S-------------S--------------------------------####--
------------------------##----------------t------------------!SS---------------||||---------------S---------------------------------------------####-#
-------g-----S---t--S-####----------------tF------t-------------!--------------||||---------------------------------------------------#------t--######
-----------C-----t----####----------------t#------t----------------------------||||----------------------g---r------gM---------#--g---#----g-t--######
-----------------t----####----------g-----tt------t----------------------------||||---------------------XXXXXXXXXXXXXXXXXXXXXXXXXXXXXXXXXXXXXXXXX###XX
---------------#-t----####XXXXXXXXX-XXXXXXXXXXXXXXXXXXXXXXXXXXXX---------------||%|---S-----------------XXXXXXXXXXXXXXXXXXXXXXXXXXXXXXXXXXXXXXXXXXXXXX
-----k-------XXXXXXXXXXXXXXXXXXXXXX-XXXXXXXXXXXXXXXXXXXXXXXXXXXX---------------||||---------------------------------------------------------------XX--
XXXXXXXXXXXXXXXXXXXXXXXXXX-----------------------------------------S---------------------o-%-%r--------o----------------------------------------------
XXXXXXXXXXXXX-------------------------------------------------------------o------------%%%--%|%%------------------------------------------------------
