--------------------------------------------------------------------------------------------------------------------------------------------------------------------------------------------------------------------------------------------------------------------------
--------------------------------------------------------------------------------------------------------------------------------------------------------------------------------------------------------------------------------------------------------------------------
--------------------------------------------------------------------------------------------------------------------------------------------------------------------------------------------------------------------------------------------------------------------------
--------------------------------------------------------------------------------------------------------------------------------------------------------------------------------------------------------------------------------------------------------------------------
--------------------------------------------------------------------------------------------------------------------------------------------------------------------------------------------------------------------------------------------------------------------------
----------------------------------------------------------------------------------g--------------------------------------------------oo-----------------------------------K-----------------------------------------------------------------------------------g##---------
-----------------------------US-------------------------------------------------SSSSSSSS---SSS!-------------------------------------SSS---------------------------------SSSSSSS@-----------------------------------------------------------------------------g###---------
------------------------------------------------------------------------------------------------------------------------------------------------------------------------------------------------------------------------------------------------------------g####---------
---------------------------------------------------------------------oo--------g-----------------------------------##--------------------------------------------------------------------------------------------------------------------------K------------#####---------
-----------------------------------------------------------------y------------------------------------------------###------------------SSS-----------------------------------K----------------------###------------oo---------------------------###-----#--######---------
---------!!-----------------####--SSC------------------ooo-------##----------S@S--------------C-----SU---------#--###-------@@@@@-D-------------------------------------SSSSSSSS---------------------------------------#----------------------------------#######---------
-----------------------y-#####----------------------------------###------------------------------------------g##--###----------------------------------K---------------------------#-----------------------#-----------#------TT-------------------------########--------F
--------------------y-######-----------------------------------####------------------------------------------###--###------------------------------------B-----------TT------------#------------C@---------#----kk-----#------TT-----r----gg------------#########--------#
--M----------------#######------------------y-y---------------#####----------------------------g-g--------g-####--###-----------K------oo----------------b-ggg-------TT------------#----yyy----------------XXXXXXXXXXXXXXXXXXXXX--XXXXXXXXXXXXX--------XXXXXXXXXXXXXXXXXXX
XXXXXXXXXXXXX--XXXXXXXXX------XX--XXXXXXXXXXXXXXXX--XXXXXXXXXXXXXXX---XXXXXXXXXXXXXXXX---XXXXXXXXXXXXXXXXXXXXXXX--XXXXXXXXXXXXXXXXXXXXXXXX----XXXXXXXXXXXXXXXXXXXXXXXXXXXXXXXXXXX--XXXXXXXXXXXXXXXX--------XXXXXXXXXXXXXXXXXXXXX--XXXXXXXXXXXXX--------XXXXXXXXXXXXXXXXXXX
XXXXXXXXXXXXX--XXXXXXXXX------XX--XXXXXXXXXXXXXXXX--XXXXXXXXXXXXXXX---XXXXXXXXXXXXXXXX---XXXXXXXXXXXXXXXXXXXXXXX--XXXXXXXXXXXXXXXXXXXXXXXX----XXXXXXXXXXXXXXXXXXXXXXXXXXXXXXXXXXX--XXXXXXXXXXXXXXXX-----------------------------------------------------------------------
