------------------------------------------------------------------------------------------------------------------------------------------------------
------------------------------------------------------------------------------------------------------------------------------------------------------
------------------------------------------------------------------------------------------------------------------------------------------------------
-----------------------------------------------------------------------------------------------------SSSSSSSSSSSSS------------------------------------
---------------------------------------------------------------------------------------------------------------------o--------------o-gg--------------
--------------------------------------------------------------------------------------------------------------------------%%--------%%%%--S--o--------
------S------------------------------S------------------------------S-------------------------------S-------------------%%|---------|||------%-------r
------------------------------------S-----------------------------------------------------------------------------------|||----o---%|||------------g-%
-------S----------------------------------------------------------------------------------------------------------------|||----%----|||-------%%%%%%%|
------------------------------o-------------------SS--------------------------------------------------------U------%---%|||-%--|----|||--So---||||||||
-----SS---TTTT-----------------!------------------------------------S--!-------------------------TT--!U----------T------|||----|%o--|||-------||||||||
----------TTTT------------TT-------------------------------------------------------------------TTTT--------------T------|||----|-%%%|||-------||||||||
----------TTTT------------TT------------t--------------y--------------------*-----------------FTTTT------t-------T------|||----|-||-|||-------||||||||
----------TTTT------------TT----------kgt-----y------ggb--ky-------y--------*----y------------XTTTT-----gt---g---T---%%-|||--or|-||-|||-------||||||||
XXXXXXX-XXXXXXXX----XXXX--XXXXXXXXXXXXXXXXXXXXXXXXXXXXXXXXXXXXXXXXXXXXXXXXXXXXXXXXXXXXXXXXXXXXXXXXXXXXXXXXXXXXXXXX---|--|||--%%%%||-|||-------||||||||
XXXXXXX-XXXXXXXX----XXXX--XXXXXXXXXXXXXXXXXXXXXXXXXXXXXXXXXXXXXXXXXXXXXXXXXXXXXXXXXXXXXXXXXXXXXXXXXXXXXXXXXXXXXXXX---|--|||--|||-||-|||-------||||||||
