-------------------------------------------------------------------------------------------------
-------------------------------------------------------------------------------------------------
-------------------------------------------------------------------------------------------------
--------------------------------------------------------------------U----------------------------
-------------------------------------------------------------------------------------------------
--------------------------------------------------------------------------------------k----------
-----------------------------US--------------------SSSSS------------------------------##---------
----------------------------------------------------------------------SS-------------###---------
---------------------------------------------------------------------------#--------####---------
----------------------------------------------------K-------------SS------##-------#####---------
---------!!-----------------####--SSC--------------SSSSS-----------------###------######---------
-----------------------y-#####--------------TT--------K---#----B--------####-----#######---------
--------------------y-######----------------TT------------#----b-------#####----########--------F
--M----------------#######------------------TT------------#----B------######---#########--------#
XXXXXXXXXXXXX--XXXXXXXXX------XX--XXXXXXXXXXXXXXXXXXXXXXXXXXXXXXXXXXX-XXXXXXXXXXXXXXXXXXXXXXXXXXX
XXXXXXXXXXXXX--XXXXXXXXX------XX--XXXXXXXXXXXXXXXXXXXXXXXXXXXXXXXXXXX-XXXXXXXXXXXXXXXXXXXXXXXXXXX
