----------------------------------------------------------------------------------------------------------------XXXXXXXXXXXXX--XXXXXXXXXXXXXXXXXXXXXXXXXXXXXXXXXXXXXXXXXXXX-
----------------------------------------------------------------------------------------------------------------------------------------------------------------------------
----------------------------------------------------------------------------------------------------------------------------------------------------------------------------
----------------------------------------------------------------------------------------------------------------------------------------------------------------------------
----------------------------------------------------------------------------------------------------------------------------------------------------------------------------
----------------------------------------------------------------------------------------------------------------------------------------------------------------------------
----------------------------------------------------------------------------------------------------------------------------------------------------------------------------
-----------------------------------------------------------------------------------------------o-----------------------------------------------------------------##---------
--------------------------------------------------------------y---oo--------------------------------------------------------------------------------------------###---------
------------------------------oo---------------------tt----2--#-----------------------o------------------------------------------------------------------------####---------
-------------------------------------------------TT--tt-------##---------------TT----------TT-----------------------------------------------------------------#####---------
-------K-------------------------------------TT--TT--tt------###---------------TT----------TT------------------y-#----------##--#------------SS!S------------######---------
-----------------#---------------------------TT--TT--tt------###----------#----TT----------TT---------------y-#####--------###--##--------------------------#######---------
--M------------kk#----------------------ggg--TT--TT--tt-----X###------------k-gTT----------TT--------K-----#########------####--###-----tt--------------tt-########--------F
XXXXXXXXXXXXXXXXXXXXXXXXXXXX------XXXXXXXXXX-XX--XX--XXXXXXXXXXX---XXXXXXXXXXXXXXXXXXXXXXXXXXXXXXXXXXXXXXXXXXXXX-####----#####--####----tt---------gg---tt#########--------#
XXXXXXXXXXXXXXXXXXXXXXXXXXXX------XXXXXXXXXX-XX--XX--XXXXXXXXXXX---XXXXXXXXXXXXXXXXXXXXXXXXXXXXXXXXXXXXXXXXXXXXX-XXXXXXXXXXXXX--XXXXXXXXXXXXXXXXXXXXXXXXXXXXXXXXXXXXXXXXXXXX
