-------------------------------------XXXXXXXXXXXXXXX--------------------------------------------------------------------------------------------------
-------------------------------------XXXXXXXXXXXXXXX-----------------------------------------------------------------------k--------------------------
--------------------------------------------------------------------------------------------------------------CSSSSSSS-----S---------------SSS--------
---------------------------------------------------------------------------------------------------------------------------------------------------K--
---------------------------------SSU---------------------------------------------------T--------------------------------------------------------------
----------------------------------------------------------------------------#----------Tt-------------------------------------------------------------
-------------------------------!----@--------------------------------------##-o--------Tt------o----------TT--2-C------------------------------------g
--------------------------------------------------------------------------###-------TT-Tt-----------------TT-----------------------------------------X
---------------------------------------S----------#S----------------###-y####-------TT-Tt---------------T-TT-----------------------------------------X
---------------------------------k---------------##----------------##########-------TT-Tt-------y--k---gT-TT-------------------------T-k--K-----------
-------------------------------SSXT-SS----------###-------k-#-----###########-XXXXXXXXXXXXXXXXXXXXXXX-XXXXXXXXXXXXXXXXXXXXXXXXXXXXXXXXXXXXXXXXXXXXXX--
----K-----------------------------T------------####--XXXXXXXXXXXXXXXXXXXXXXX#-XXXXXXXXXXXXXXXXXXXXXXX-XXXXXXXXXXXXXXXXXXXXXXXXXXXXXXXXXXXXXXXXXXXXXX--
----------------------------------XX----------#####--XXXXXXXXXXXXXXXXXXXXXXXXX------------------------------------------------------------------------
----------------------------------XX---------######-------------------------XX------------------------------------------------------------------------
XXXXXXXXXXXXXXXXXXXXXXXXXXXXXXXXXX----------#######---------------------------------------------------------------------------------------------------
XXXXXXXXXXXXXXXXXXXXXXXXXXXXXXXXXX---------########---------------------------------------------------------------------------------------------------
