----------------------------------------------------------------------------------------------------------------------------------------------------------------------------------------------------------------------------------------------------------------------------------
----------------------------------------------------------------------------------------------------------------------------------------------------------------------------------------------------------------------------------------------------------------------------------
----------------------------------------------------------------------------------------------------------------------------------------------------------------------------------------------------------------------------------------------------------------------------------
----------------------------------------------------------------------------------------------------------------------------------------------------------------------------------------------------------------------------------------------------------------------------------
----------------------------------------------------------------------------------------------------------------------------------------------------------------------------------------------------------------------------------------------------------------------------------
----------------------------------------------------------------------------------------------------------------------------------------------------------------------------------------------------------------------------------------------------------------------------------
-----------------------------------------------------------------------------------------------------------------------------------------------------------------------------------------------------------------------------------------------------------------------##---------
----------------------------------------------------------------------------------------------------------------------------------------------------------------------------------------------------------------------------------------oooo--------------------------###---------
------------------------------------------------------------------------------------------------------------------------------------------------------------------------------------------------------------------@--------------------------------------------------####---------
------------------------------------------------------------------------------------------------------oooo-----------------------------oooooo-----------------------------------oooooo------------------------------------------------------------------------------#####---------
----------------------------------------------------------------------------------------------------------------------------##---------------------------------------##--------------------------------------------------------ooo---------------------------------######---------
-----------------------------------------------------------TT-----TT----K-------------------TT----------------K-------------###---------------------------K----------###--------------------------K--------------------------------------TT-----------------------#######---------
-----------------------------------------------------------TT-----TT---------K---------#----TT---------------------K--------####-------------------------------------####-----------------------------------------#----------------------TT----------------------########--------F
--M------k----ggg--------kkk-------ggg-------ggg---------kkTT-----TT-------------#-----##---TT------kk-----------------#----#####-----TT-----##----gg-----------#----#####-----TT-----##----gg----------K-----#---#-------k-kkk----kk----TT----k---ggg------ggg-#########--------#
XXXXXXXXXXXXXXXXXXXXXXXXXXXXXXXXXXXXXXXXXXXXXXXXXXXXXXXXXXXXXXXX--XXXXXXXXXXXXXXXX-----XXX--TTXXXXXXXXXXXXXXXXXXXXXXXXXX----XXXXXX----TT------XXXXXXXXXXXXXXXXXXX----XXXXXX----TT------XXXXXXXXXXXXXXXXXXXXXXXX---X--XXXXXXXXXXXXXXXXXXXXXXXXXXXXXXXXXXXXXXXXXXXXXXXXXXXXXXXXXXXXX
XXXXXXXXXXXXXXXXXXXXXXXXXXXXXXXXXXXXXXXXXXXXXXXXXXXXXXXXXXXXXXXX--XXXXXXXXXXXXXXXX-----XXX--TTXXXXXXXXXXXXXXXXXXXXXXXXXX----XXXXXX----TT------XXXXXXXXXXXXXXXXXXX----XXXXXX----TT------XXXXXXXXXXXXXXXXXXXXXXXX---X--XXXXXXXXXXXXXXXXXXXXXXXXXXXXXXXXXXXXXXXXXXXXXXXXXXXXXXXXXXXXX
