--------------------------------------------------------------------------------------------------------------------------------------------
--------------------------------------------------------------------------------------------------------------------------------------------
--------------------------------------------------------------------------------------------------------------------------------------------
--------------------------------------------------------------------------------------------------------------------------------------------
--------------------------------------------------------------------------------------------------------------------------------------------
--------------------------------------------------------------------------------------------------------------------------------------------
------------------------------------------------------------------------SUS------------------------------------------------------##---------
---------------------------------------------------------------------------------------------------------------------------------##---------
------------------------------------------------------------------------------------------------TT-------------------------------##---------
------------------------------------------------------------------------------------------------TT------------------------K---#--##---------
-----------------------------------------------------------------------#####-----------#LSS-----##---------------------------##--##---------
-------K--------------------TT-----TT----K-----------------------------#---------------#------------------------------------###--##---------
----------------------------TT-----TT---------------------------------K#---------------#-----------*---TT-----*------------####------------F
--M-----------ggg---------kkTT-----TT---------ggg-------ggg------------#-------------kk#-----------*---TT-----*-----K-----#####------------#
XXXXXXXXXXXXXXXXXXXXXXXXXXXXXXXXX--XXXXXXXXXXXXXXXXXXXXXXXXXXXXXXXXXXXXXXX----XXXXXXXXXXXXXX---XXXXXXXXXXXXXXXXXXXXXXXXXXXXXXXXXXXXXXXXXXXXX
XXXXXXXXXXXXXXXXXXXXXXXXXXXXXXXXX--XXXXXXXXXXXXXXXXXXXXXXXXXXXXXXXXXXXXXXX----XXXXXXXXXXXXXX---XXXXXXXXXXXXXXXXXXXXXXXXXXXXXXXXXXXXXXXXXXXXX
