------------------------------------------------------------------------------------------------------------------------------------------------------------------------------------
------------------------------------------------------------------------------------------------------------------------------------------------------------------------------------
------------------------------------------------------------------------------------------------------------------------------------------------------------------------------------
------------------------------------------------------------------------------------------------------------------------------------------------------------------------------------
------------------------------------------------------------------------------------------------------------------------------------------------------------------------------------
------------------------------------------------------------------------------------------------------------------------------------------------------------------------------------
---------------------LSSS------------------------------------------------!-!-------------------------!!!!---------------------------------------------------------------###---------
------------------------------------------------------------------------------------------------------------------------------------------------------------------------###---------
-----------------g---------------------------------------------------------------------------------------------------------------------------------------------------y--###---------
-----------------#---------------------------------oo--------------------------------------------------y-------------------------------------------------------------#--###---------
--------SUS-----##---2-----#----------------------o--o-------------------!-!-----------------------!!@SS!!!---------------------------------------------------------##--###---------
---------------###---------#------------------------------------------------------------------------------------------------------------------#--------------------###--###---------
--------------####---------##---------------------------------------------------------------------------------------TT------------------------#-------------------####--###--------F
--M----------#####----kk---##---S--ggg-------------------------y-------------y--------------------------------------TT------------------------#----y--y----------#####--###--------#
XXXXXXXXXXXXXXXXXXXXXXXXXXXXXXXXXXXXXXX--XXXXXXXXXXXXXXXXXXXXXXXXXXXXXXXXXXXXXXXXXXXXXX----XXXXXXXXXXX--XXXXXXXXXXXXXXXXXXXXXXX---XXX--XXXXXXXX--XXXXXXXXXXXXXXXXXXXXX--XXXXXXXXXXXX
XXXXXXXXXXXXXXXXXXXXXXXXXXXXXXXXXXXXXXX--XXXXXXXXXXXXXXXXXXXXXXXXXXXXXXXXXXXXXXXXXXXXXX----XXXXXXXXXXX--XXXXXXXXXXXXXXXXXXXXXXX---XXX--XXXXXXXX--XXXXXXXXXXXXXXXXXXXXX--XXXXXXXXXXXX
