--------------------------------------------------------------------------------
--------------------------------------------------------------------------------
--------------------------------------------------------------------------------
--------------------------------------------------------------------------------
--------------------------------------------------------------------------------
--------------------------------------------------------------------------------
-----------------------------US-------------------------------------g##---------
-------------------------------------------------------------------g###---------
------------------------------------------------------------------g####---------
------------------------------------------------------------------#####---------
---------!!-----------------####--SSC------------------ooo-------######---------
-----------------------y-#####----------------------------------#######---------
--------------------y-######-----------------------------------########--------F
--M----------------#######------------------y-y---------------#########--------#
XXXXXXXXXXXXX--XXXXXXXXX------XX--XXXXXXXXXXXXXXXX--XXXXXXXXXXXXXXXXXXXXXXXXXXXX
XXXXXXXXXXXXX--XXXXXXXXX------XX--XXXXXXXXXXXXXXXX--XXXXXXXXXXXXXXXXXXXXXXXXXXXX
