------------------------------------------------------------------------------------------------------------------------------------------
------------------------------------------------------------------------------------------------------------------------------------------
------------------------------------------------------------------------------------------------------------------------------------------
------------------------------------------------------------------------------------------------------------------------------------------
------------------------------------------------------------------------------------------------------------------------------------------
------------------------------------------------------------------------------------------------------------------------------------------
-----------------------------US------------------------------------------------------------------------------------------------##---------
-------------------------------------------------------------------------------------------------------------------------------##---------
-----------------------------------------------------------------------------------------------------------------------------#-##---------
----------------------------------------------------o----o-------------------oo---oo-----------------------------------------#-##---------
---------!!-----------------####--SSC--------------------------------------------------------------------------------------#-#-##---------
-----------------------y-#####---------------------------------------------------------------------------TT----------------#-#-##---------
--------------------y-######------------------------------------#---#------------------------------------TT---------TT---#-#-#-##--------F
--M----------------#######------------------y-y-----------------#-k-#-----------------------k------kkk---TT---------TT---#-#-#-##--------#
XXXXXXXXXXXXX--XXXXXXXXX------XX--XXXXXXXXXXXXXXXX---XX---XXXXXXXXXXXXXXXX-----X----XXXXXXXXXXXXXXXXXXXXXXXXXXXXXXXXXXX-X-X-X-XXXXXXXXXXXX
XXXXXXXXXXXXX--XXXXXXXXX------XX--XXXXXXXXXXXXXXXX---XX---XXXXXXXXXXXXXXXX-----X----XXXXXXXXXXXXXXXXXXXXXXXXXXXXXXXXXXX-X-X-X-XXXXXXXXXXXX
