---------------------------------XXXXXXXXXXXXX---------------g----------------tt---------------------------------------------------------------------------2r--------------rS------------r-------2r---SSS------------------------------------------------r-------------------------XXXXX--XXXXXXXXXXXXXXXXX---------------------------r--------------------------------r---------r--r--##r--r--gXXXX-r------TT--
----------------------------------XXXXXXXXXXXX----T----------TT---------------tt--------K---------r-S-------------------r-------------------------------------------r------------------------------------------------r-----------------------------r------------------------------------------------------------r-----------r----------------r--r--------------------------------------XXXXXXXXXXXXX-----r--TT--
-------------r------------------------------------TT---------Tr--------###--r-tt-------SSSSSSSSSrr---S---r-----------------------2--------------------r---------------------------------------------------r--2---------------r---------------------r-----------------------------------------------------------------------------------------------------------------------------------XXXXXXXXX-------XXXXXXXXX
--------------------------------------------------TT---r-----TT--rr---##r#--r-tt---------r------S-Syo---------------------------------------------------------------------------------------------o----K---------r--------------------------------r------------------r-SS--------------------------------------r-----------r--------------------------------------------------------r------------------XXXXXXXXX
--------------------------------------r-----------XT---------TTXXXXXXXXXXXXXXXXX-------------------C--r-r------r-------------------------r-------------#LS-------------------------------------------SSSSr------------------------------------------r------------rSSSS------------------r----------------------rSS--------r--------------r--------------------------------r---------------------r---------------
--------------------------------------------------X-XXXXXXXXXXXXXXXXXXXXXXXXXXXX--X--------#---K------S---------------------------oo-----------------T-#------rr-------#-----r---------------K--------------------------K----B--------k--------------------------------------------------------------------r------------------------------------r---------------1---------------------------r-------r-----------
-------r--------!!!!!----r--------------------------XXXXXXXXXXX-------------------XXXXXXXXXXXXXX--rS------------------------------------------------TTT#------rrrr-----#---------r-------------------------r----r-------r----b-------g#------------------------C----------------------r-----------r---r-----!---------------S-------r---------------------------------------------------------------------r-----
---------------------------------------------------r--------------r----------------XXXXXXXXXXXXX----------------------------------------K------B----TTT#--r-XXXXXXXX---#--XXX----X-r---rrr------r---------XXXXX---rrrr---r---B-------##--------------------------------SS------TT---r--r----------2rr-S----2--------------------------------o-------------------------------r-----------------------------------
--------------------------------------------------r-----------------------------------r-----r---r--------------#----------g------------------K-b----TXXXXXXXXXXXXXXX-XXX--XXX----X----XXXXXXXXXXXXXXXXXXXXXXXXX---XXXXXXXr--XX------###----r-B--------------------r---C-------#TT-----------------------------------------ro---------r--------------------------ggg------------------------r--------------------
------------------k---------o-----@---------------------------------------------r---------------------r--------#----------r-----r---------r----Brr--TXXXXXXX--------rXXX--------------XXXXXXXXXXXXXXXXXXXX--------XXXXXXXXXXXX-----####------b-r--gg------r---gg-------------##TTT----------------------------------------r--------S----------------------##########---#--------------------------------r-------
-------#@@@@----@!!!!-----------------------------------------------------------rr---------------------r-------#-rr----r-XXXXXXXXXXXXXXXXXX-XXXXXXXXX--------------------------------------------------------------------XXX---X--#####XXXXXXXXXXXXX------XXXXXXXXX---------###TTTT--------r----------------@-------------T--------------------r---------##--------#---#----r-----------------------------------
-------r---------------------------------------------------------------------r------------------r-------XXXXXXXXXXXXXXXXXXXXXXXXXXXXXXXXXXX-XXXXXXXXX-------r-------------r-----------------------r-------r--------------------XXXXXXXXXXXXXXXXXXXXX-r-XXXXXXXXXXXXXXXXXXXXXXXXXXTT----------------!S---------------------T-------------------r----K----###--------#---##-----------K---------------------------
----r----------------------------r---------ooo---------------------r-----------------------------------rXXXXXXXXXXXXXXXXX----------------------------r----------------------------r---------------------------------------------XXXXXXX----------------XXX---------XXXXXXXXXXXXXXXT----K---#---K----------------X------r--T----r--ggr-r------XXX-------####--------#---##--Xr-----------------------------------
--M---------r----------gg---------r---K----------------r-----------------------------------g-----------------------------------------------r----------------------------r----r---------------------------------------------------------------------------------------------------rX--------#-----------------XXXX-r--XXXXXXX-XXXXXXXXXXXXX---XXXXXXXXXXXXXX--------X---XXXXXX----r------------------------------
XXXXXXXXXXXXXrXXXXXXXXXXXX---XX------------------r-----r--------------------------------SSSSSS@SS----------------------------------------r--------------------r---------------------------------------------------------r------r------------------r-------------------------------Xr-------#-----r------rrr-XXXX-----XXXXXXX-XXXXXXXXXXXXX------XXXXXXXXXXX--------X---XXXX---XXXXXXX-----------r--------r---TT-
XXXXXXXXXXXXXXXXXXXXXXXXXX---XX---X----kk---------------------------------------------------------------r---------------------------------------------------------------------------r------------------------2--------------r-------------------------------------------------------XXXXX--XXXXXXXXXXXXXXXXXX-----------------------------------------------------------------XXXXXXXr--#-----------#--------TT-
