---------------------------------------------------------------------------------------------------------------------
------------------------------------------------------------------------------------------SSSSSSSSSSSSSSSSSSSSSSSSSS-
------------------------------------------------------------------------------------------SSSSSSSSSSSSSSSS-----------
------------------------------------------------------------------------------------------SSSSSSSSSSSSSSSS-----------
------------------------------------------------------------------------------------------SSSSSSSSSSSSSSSS-----------
------------------------------------------------------------------------------------------S-------------------TT-----
---------------------LSSS---------------------!!!!!-----------USSS--------SSCSS------SSSS---------------------TT-----
--------------------------------------------------------------------------------------------oooooooooo--------TT-----
-----------------g-------------------------------------------------------------------------USSSSSSSSSS----#---TT----F
-----------------#------------------------------k--------------------------------------------------------##---TT---SS
--------SUS-----##---2-----#-----------TT-----@!!!!----------S-----TT---!!!!--!!!-----------------------###---TT---SS
---------------###---------#-----------TT--------------------------TT-----------------------------kk---####--kTT---SS
--------------####---------##----------TT--------------------------TT---------------------XXXXXXXXXXXXXXXXXXXXXXX--XX
--M-----T----####-----kk---##---gg-----TT------------gg----k-ggg---TT------------ggg------XXXXXXXXXXXXXXXXXXXXXXX--XX
XXXXXXXXXXXXXXXXXXXXXXXXXXXXXXXXXXXXXXXXXXXXXXXXXXXXXXXXXXXXXXXXXXXXXXXXXXXXXXXXXXXXX--------------------------------
XXXXXXXXXXXXXXXXXXXXXXXXXXXXXXXXXXXXXXXXXXXXXXXXXXXXXXXXXXXXXXXXXXXXXXXXXXXXXXXXXXXXX----X---------------------------
