----------------------------------------------------------------------------------------------------------------------------------------------------------------------------------------------------------------------------------------------------------------------------------------------------------------------------------------------------------------------------------------------------------------
----------------------------------------------------------------------------------------------------------------------------------------------------------------------------------------------------------------------------------------------------------------------------------------------------------------------------------------------------------------------------------------------------------------
--------------------------------------------------------------g-------------------------------------------------------------------------------------------------------------------------------------------------------------------------------------------------------------------------------------------------------------------------------------------------------------------------------------------------
----------------------------------------------------------------------------------------------------------------------------------------------------------------------------------------------------------------------------------------------------------------------------------------------------------------------------------------------------------------------------------------------------------------
---------------------------------g-------------------------------------------------------------------------------------------------------------------------------------------g----------------------------------------------------------------------------------------------------------------------------------------------------------------------------------------------------------------------------------
------------------------g------------------------------------------g-----------------------------------------------------------------------------------------------g----------------g-------g--------------------------------------------------------k----g-----------------------------------------------------------------------------------------------------------------------------------------------------
---------------------LSSS---------------------!!!!!-----------USSS--------SSCSS------SSSS-----------------------------USSS-----------------------------------SSSS!--------------@-----------SSS--g-S!!S---------------------------------------------S!S--S!S----------------------------------------------------------------------------------------------------------------------------------------------------
------------------------------------------------------------------------------------------------------------g-----------------------------------------------------------------------------------------------------------------------------------------------------------------------------------------------------------------------------------------------------------------------------g---------------------
-----------------g------------------------------------------------------------------------------g-----------------------------------------------------------------------------------------------------------------------------------------g#---------------gg----------------g-----------------------------------------------------------------------------------------g----------------------------------------
-----------------#------------------------------k-----------------------------------------------g--------------------------TT---------------------------------------------------------------------------------------------g---g----------g##-----------------------------------------------------------------------B---------------------------------------------------------------g#---------------------------
--------SUS-----##---2-----#-----------TT-----@!!!!----------S-----TT---!!!!--!!!---------------TT-----------------TT------TT-----------------------------C------C-----SU----!--!--!-----S----------SS------g--#----------##--#----------###--------S!S--S@S-----------------k------------------U---------SS------S#2--------------------------------------------------K-----------##--------------------S@-----
---------------###---------#-----------TT--------------------------TT--------------------------gTT----------g------TT--tt--TT----------------------#-------------------------------------------------------##--##-------g###--##--------####--------------------------TT-----TT----K-------------------------------------B----------------------------TT---------K---------------g###--------------B------------
--------------####---------##----------TT--------------------------TT---------------------------TT----------TT-----TT--tt--TT------------------K---#------------------------------------------------------###--###------####--###------#####--------------------------TT-----TT-g--------------------g-------------------b-----TT----K----TT----------TT-----TT-----K----B-------####------B-----K-bK----------B
--M-------g--#####----kk---##-k-ggg--g-kg---g--g-----gg----k-ggg---TT------g-----ggg------------TT-------g--gT--gT-TT--tt-gkT----gk----------k-----#-----gg-------g-g-------gk-----bg--k-------gg-g-g----g###--####----#####--####----g#####------k------ggg-----g--kkTT-g----T-------k---gggg-------b--y--k---B--y-y---gb-----TT--g------TT----------kT---g-TT-----g----b------#####-y-kB-b-------------gk---gg
XXXXXXXXXXXXXXXXXXXXXXXXXXXXXXXXXXgXXXXXXXXXXXXXXXXXXXXXXXXXXXXXXXXXXXXXXXXXXXXXXXXXX----XXXXXXXXXX---XXXXXXXXXXXXXXXXXXXXXXXXXXXXXX---XXXXXXXXXX--XXXXXXXXXXXXXXXXXXXXXXXXXXXXXXXXXXXXXXXXXXXXXXXXXXXXXXXXXXXXXXXXXXXXXXXXX--XXXXXXXXXXXXXX--XXXXXXXXXXXXXXXXXXXXXXXXXXXXX--XXXXXXXXXXXXXXXXXXXXXXXXXXXXXXXXXXXXXXXXXXXXXXXXXXXXXXXXX-XXXXX-X------XXXXXXXXXgXXXXXXXXXX-X---XXXXXXXXXXXXX-XXXXXXXXXXXXXXXXXXXXX
XXXXXXXXXXXXXXXXXXXXXXXXXXXXXXXXXXXXXXXXXXXXXXXXXXXXXXXXXXXXXXXXXXXXXXXXXXXXXXXXXXXXXX---XXXXXXXXXX---XXXXXXXXXXXXXXXXXXXXXXXXXXXXXX---XXXXXXXXXX---XXXXXXXXXXXXXXXXXXXXXXXXXXXXXXXXXXXXXXXXXXXXXXXXXXXXXXXXXXXXXXXXXXXXXXXX--XXXXXXXXXXXXXX--XXXXXXXXXXXXXXXXXXXXXXXXXXXXX--XXXXXXXXXXXXXXXXXXXXXXXXXXXXXXXXXXXXXXXXXXXXXXXXXXXXXXXXX-XXXXX-X------XXXXXXXXXXXXXXXXXXXX-X---XXXXXXXXXXXXX-XXXXXXXXXXXXXXXXXXXXX
