-------------------------------------------------------------------------------------------------------------------------------------------------------------------
-------------------------------------------------------------------------------------------------------------------------------------------------------------------
-------------------------------------------------------------------------------------------------------------------------------------------------------------------
-------------------------------------------------------------------------------------------------------------------------------------------------------------------
-------------------------------------------------------------------------------------------------------------------------------------------------------------------
-----------------------------------------------------------------------------------------------------------------k---------------------------------------k---------
-------------------------------------------------------------------------SS!SSS@SSS--------SSC------------------S!S--S!S--------------------------------##---------
-------------------------------------------------------------------------------------------------------------------------------------------------------###---------
------------------------------------------------------------------------------------------------------g#---------------------------------#-----------k####---------
---------------------------------------------------------------------------K---------------SSS-------g##---------------------------k-----#-----------#####---------
-----------------------------------------------------------------TT------SSSSSSSSSSS-----------------###--------S!S--S@S--------SCSSS----#----------######---------
-------K--------------------TT-----TT----K-----------------------TT---------------------------------####--------------------------K-----##---------#######---------
----------------------------TT-----TT----------------------------TT--------------------------------#####--------------------------------##--------########--------F
--M-----------ggg---------kkTT-----TT-----------ggg-------ggg----TT--------------K----------------######------k------ggg--------K---K---##-------#########--------#
XXXXXXXXXXXXXXXXXXXXXXXXXXXXXXXXX--XXXXXXXXXXXXXXXXXXXXXXXXXXXXXXXXXXXXXXXXXXXXXXXXXXXXXXX----XXXXXXXXXX--XXXXXXXXXXXXXXXXXXXXXXXXXXXXXXXX---XXXXXXXXXXXXXXXXXXXXXX
XXXXXXXXXXXXXXXXXXXXXXXXXXXXXXXXX--XXXXXXXXXXXXXXXXXXXXXXXXXXXXXXXXXXXXXXXXXXXXXXXXXXXXXXX----XXXXXXXXXX--XXXXXXXXXXXXXXXXXXXXXXXXXXXXXXXX---XXXXXXXXXXXXXXXXXXXXXX
