---------------------------------------------------------------------------oo----------------------------------------------------------------------------------------------------------------------------------------------------------------------------------------------------------------------------------------------------------------------------
---------------------------------------------------------------------------------------------------------------------------------------------------------------------------------------------------------------------------------------------------------------------------------------------------------------------------------------------------------
-----------------------------------------------------------------------------%%%%------------------------------------------------------------------------------------------------------------------------------------------------------------------------------------------------------------------------------------------------------------------------
----------------------------------------------------------------------SSS-----||--------------------------------------------------------------------------------------------------------------------------------------------------------------------------------------------------------------------------------------------------------------##---------
------------------------------------------------------------------------------||--------------------------------------------------------------------------------------------------------@-------------S1SSSSSS---------------------------------------------------------------------------------------------------------------------------K----##---------
-------------------------------------------oo---%%%%--------------------------||------------------------------------------------oooo-----------------------------oooooo-----------------------------------------------------------------------------------------------------------------------------------------------------------------------##---------
---------------SSS-----------------SSS-----SS----||--------------SSS----------||-------------------------ooo------------------------------------------##-------------------------------------------------------------------------------------------------B---------------------------------------------------------------g#----------------#--##---------
-------------------------------------------------||------SSS-oo---------------||---TT---------------------------------TT----------------K-------------###----------------------------------------------------------------------------S@---------SS------S#2--------------------------------------------------K-----------##----------------#--##---------
-------------------------------------------------||---------------------------||---TT----------------------------#----TT---------------------K--------####------------------------------#----------------------SS--------------B-------------------------------B----------------------------TT---------K---------------g###----B---------#-#--##---------
----%%%%%%--------------%%%%%%----------------SS-||%%%%%-----SS---------------||---TT----gg---------kkk----------##---TT------kk-----------------#----#####-----TT-----##----gg-----#---#--------------#---------------B-----K-bK----------B-------------------b-----TT----K----TT----------TT-----TT-----K----B-------####----b--------##-#--##--------F
-----||||----------------||||--------------------||-|||-----------------------||-XXXXXXXXXTTXXXXTTXXXXXXXXXXX----XXX--TTXXXXXXXXXXXXXXXXXXXXXXXXXX----XXXXXX----TT------XXXXXXXXXXXXX---X--------------#---------------b-------B-----------b--y------B--y-y----b-----TT---------TT----------TT-----TT----------b------#####-y--B-------###-#--##--------#
-----||||----------------||||--------------------||-|||-----------------------||-XXXXXXXXXTTXXXXTTXXXXXXXXXXX----XXX--TTXXXXXXXXXXXXXXXXXXXXXXXXXX----XXXXXX----TT------XXXXXXXXXXXXX---X--XXXXXXXXXXXXX-XXXXXXX--XXXX-XXXXXXXXXXXXXXXXXXXXXXXXXXXXXXXXXXXXXXXXXXXXXXXXXXXXX-XXXXX-X------XXXXXXXXXXXXXXXXXXXX-X---XXXXXXXXXXXXXXXXXXXXXXX-X--XXXXXXXXXXX
--M--||||----------------||||--------------------||-|||------------------------------------------------------------------------------------------------------------------------------------XXXXXXXXXXXXX-XXXXXXX--XXXX-XXXXXXXXXXXXXXXXXXXXXXXXXXXXXXXXXXXXXXXXXXXXXXXXXXXXX-XXXXX-X------XXXXXXXXXXXXXXXXXXXX-X---XXXXXXXXXXXXXXXXXXXXXXX-X--XXXXXXXXXXX
%%%%-||||-%%%%%%----%%%%-||||-%%%%%%---%%%%-----%%%%|||--------------------------------------------------------------------------------------------------------------------------------------------------------------------------------------------------------------------------------------------------------------------------------------------------
-||--||||--||||------||--||||--||||-----||-------||-|||--------------------------------------------------------------------------------------------------------------------------------------------------------------------------------------------------------------------------------------------------------------------------------------------------
-||------------------------------------------------------------------------------------------------------------------------------------------------------------------------------------------------------------------------------------------------------------------------------------------------------------------------------------------------------
