--------------------------------------------------------------------------------------------------------------------------------------------
--------------------------------------------------------------------------------------------------------------------------------------------
--------------------------------------------------------------------------------------------------------------------------------------------
--------------------------------------------------------------------------------------------------------------------------------------------
--------------------------------------------------------------------------------------------------------------------------------------------
--------------------------------------------------------------------------------------------------------------------------------------------
-----------------------------USSSSS!--------------@-----------SSS----S!!S--------------------------------------------------------##---------
--------------------------------------------------------------------------------------------------------------------------------###---------
-------------------------------------------------------------------------------------------------------------------------------####---------
------------------------------------------------------------------------------------------------------------------------------#####---------
---------!!-----------------###----C-----SU----!--!--!-----S----------SS------#--#----------##--#------------SS!S------------######---------
-----------------------y-#####-----------------------------------------------##--##--------###--##--------------------------#######---------
--------------------y-######------------------------------------------------###--###------####--###-----tt--------------tt-########--------F
--M----------------#######----------g-g--------k-----------------gg-g-g----####--####----#####--####----tt---------gg---tt#########--------#
XXXXXXXXXXXXX--XXXXXXXXX------XXXXXXXXXXXXXXXXXXXXXXXXXXXXXXXXXXXXXXXXXXXXXXXXXXXXXXXXXXXXXXXX--XXXXXXXXXXXXXXXXXXXXXXXXXXXXXXXXXXXXXXXXXXXX
XXXXXXXXXXXXX--XXXXXXXXX------XXXXXXXXXXXXXXXXXXXXXXXXXXXXXXXXXXXXXXXXXXXXXXXXXXXXXXXXXXXXXXXX--XXXXXXXXXXXXXXXXXXXXXXXXXXXXXXXXXXXXXXXXXXXX
