-----------------------------------------------------------------------------------------------------
-----------------------------------------------------------------------------------------------------
-----------------------------------------------------------------------------------------------------
-----------------------------------------------------------------------------------------------------
-----------------------------------------------------------------------------------------------------
-------------------------------------------------------------------------k---------------k##---------
---------k-----------LSSS------------------S---------------------------------------------###---------
-------------r---------------------------------------------------------------------------k##---------
-----------------k-------------------------------------------------------------------g---###---------
-----------------#-----------------------------------------------k------gg-----S-----##--###---------
--------SUS-----##---2-----#----------------S!S------------------####-########----k####--###---------
---------------###---------#------------------------------------##----------------#####--###--------F
--------------####---------##-------------C-------------TT-----###---------------######--###--------#
--M----------#####----kk---##------B--yk---------gg---kT-T-----###-------------XXXXXXXX--XXXXXXXXXXXX
XXXXXXXXXXXXXXXXXXXXXXXXXXXXXXXXXXXXXXXXXXXXXXXXXXXXXXXXXXXXXXXXXX--------------XXXXXXXX-XXXXXXXXXXXX
XXXXXXXXXXXXXXXXXXXXXXXXXXXXXXXXXXXXXXXXXXXXXXXXXXXXXXXXXXXXXXXXXX-----------------------------------
