---------------------------------------------------------------------------------------------------
---------------------------------------------------------------------------------------------------
---------------------------------------------------------------------------------------------------
---------------------------------------------------------------------------------------------------
---------------------------------------------------------------------------------------------------
---------------------------------------------------------------------------------------------------
----------------------------------------------------------------------------------------##---------
----------------------------------------------------------------------------------------##---------
-------------------------------------------------------TT-------------------------------##---------
-------------------------------------------------------TT------------------------K---#--##---------
----------------------------------------------#LSS-----##---------------------------##--##---------
----------------------------------------------#------------------------------------###--##---------
----------------------------------------------#-----------B---TT-----B------------####------------F
--M------------k------ggg------kkk----------kk#-----------b---TT-----b-----K-----#####------------#
XXXXXXXXXXXXXXXXXXXXXXXXXXXXXXXXXXXXXXXXXXXXXXXXXXX---XXXXXXXXXXXXXXXXXXXXXXXXXXXXXXXXXXXXXXXXXXXXX
XXXXXXXXXXXXXXXXXXXXXXXXXXXXXXXXXXXXXXXXXXXXXXXXXXX---XXXXXXXXXXXXXXXXXXXXXXXXXXXXXXXXXXXXXXXXXXXXX
