--------------------------------------------------------------------------------------------------------------------------------------------------------------------------
--------------------------------------------------------------------------------------------------------------------------------------------------------------------------
--------------------------------------------------------------------------------------------------------------------------------------------------------------------------
--------------------------------------------------------------------------------------------------------------------------------------------------------------------------
--------------------------------------------------------------------------------------------------------------------------------------------------------------------------
--------------------------------------------------------------------------------------------------------------------------------------------------------------------------
----------------------------------------------------------------------------------------------SUS--------------------------------------------------------------##---------
--------------------------------------------------------------------------------------------------------------------------------------------------------------###---------
-------------------------------------------------------------------------------------------------------------------------------------------------------------####---------
-------------------------------------------------------------------------------------------------------------------------tt---------------------------------#####---------
---------------------------------------------------------------------------------------------#####-------------------TT--tt--------------------------------######---------
--------------------------------------------------TT-----TT----K-----------------------------#-------------------TT--TT--tt-------------------------------#######---------
--------------------------------------------------TT-----TT---------------------------------K#-------------------TT--TT--tt------------------------------########--------F
--M------k---ggg--------ggg-------ggg-----------kkTT-----TT-----------ggg-------ggg----------#--------------ggg--TT--TT--tt-----k--ggg-----ggg------ggg-#########--------#
XXXXXXXXXXXXXXXXXXXXXXXXXXXXXXXXXXXXXXXXXXXXXXXXXXXXXXX--XXXXXXXXXXXXXXXXXXXXXXXXXXXXXXXXXXXXXXX----XXXXXXXXXXX-XX--XX--XXXXXXXXXXXXXXXXXXXXXXXXXXXXXXXXXXXXXXXXXXXXXXXXXX
XXXXXXXXXXXXXXXXXXXXXXXXXXXXXXXXXXXXXXXXXXXXXXXXXXXXXXX--XXXXXXXXXXXXXXXXXXXXXXXXXXXXXXXXXXXXXXX----XXXXXXXXXXX-XX--XX--XXXXXXXXXXXXXXXXXXXXXXXXXXXXXXXXXXXXXXXXXXXXXXXXXX
