--------------------------------------------------X---XXXXXXXXXXXXXXXXXXXXXXXXXX---XXXXXXXXXXXXXXXXXXXXXXXXXXXXXXXXXXXXXXXXXXXXXXXXXXXXXXXXXXX-X-XXXXXXXX-XXXXXXXXXXXXXXXXXXXXXXXXXXXXXXXXXXXXXXXXXXXXXXXXXXXXXXXXXXXXXXXX-
---------------------------------------------------------------------------------------------------------------------------------------------------------------------------------------------------------------------------
---------------------------------------------------------------------------------------------------------------------------------------------------------------------------------------------------------------------------
---------------------------------------------------------------------------------------------------------------------------------------------------------------------------------------------------------------------------
---------------------------------------------------------SSSSSSSSSSSSSSSSSSSSSSSSSSSSSSSSSLSSSSSSSSSSSSSSSSSSSSSSSSSSSSSSSSSSSSSSSSSSSSSSSSS-------------------------------------------------------------------------------
---------------------------------------------------------SS--SSSS--SSSS------SSSS-------------------------------------------------------------------------------------------------------------------------------K----------
---------------------------------------------------------SS--SSSS--SSSS---g--SSSS------------------------------------------------------------------------------------------------------------------------------------------
------------------------------------------------1-------USS----SS---S----SS----------oooooo---------------------------------------------------US---SS-------------SSS-------------------------------------------##---------
---------------------------------------------------------------SS---S----SS----------------------------------------TT----------------------------------------------------TT------------------------------------###---------
---------------------------oo----------------------------------SS---S----SS----------SSSSSS------------------------TT----------------------------------------------------TT-----------------------------------####---------
------------------------------------------------ggg----------ooSS---SoU--SC--g-g-----SSSSSS------------------------TT-------S---------------SS---------------------------TT----------------------------------#####---------
-------K----------------------------------##########---#---#-SSSS---SSS--SS--SSSS----------------------g---------SCTTSU----------------TT---------SSS---------#---SSS----XX-----TT-------TT----------------TT#####---------
---------------#--------------------------##-------#---#---#-------------------------------------------#--t--------TT----TT---tt-------TT----------------#-TT-#-----------------TT-----TTTT----TT---------#TT#####---------
--M----------kk#---------------------ggg--#--------#---##--#---------------------------------------#-g##--tt-------TT----TT---tt-------TT---------------##-TT-##----------------TT---TTTTTT----TT--------##TT#####--------F
XXXXXXXXXXXXXXXXXXXXXXXXX------XXXXXXXXXX-X--------#---##--#----g-g------------------------------g-#-###-ktt------kTT---kTT--ktt-------TT--g-----------###-TT-##---------k------TT---TTTTTT----TT-------###TT#####--------#
XXXXXXXXXXXXXXXXXXXXXXXXX------XXXXXXXXXX-X--------X---XXXXXXXXXXXXXXXXXXXXXXXXXX---XXXXXXXXXXXXXXXXXXXXXXXXXXXXXXXXXXXXXXXXXXXXXXXXXXXXXXXXXXX-X-XXXXXXXX-XXXXXXXXXXXXXXXXXXXXXXXXXXXXXXXXXXXXXXXXXXXXXXXXXXXXXXXXXXXXXXXX
