------------------------------------------------------------------------------------------------------------------------------------------------------
------------------------------------------------------------------------------------------------------------------------------------------------------
------------------------------------------------------------------------------------------------------------------------------------------------------
----------------------------------------------------------------------------------------------------------------------------------------------S-------
------------------------------------------------------------------------------------------------------------------------------------------------------
------------------------------------------------------------------------------------------------------------------------------------------------------
---------------------------------------------!S-------------------S-----U---------------------------------------------------------------------SSSS----
---------------------------------------------------o------------------------------------------------------------------------------------------S-------
----------------------------------------------------------------------------------------------------------------------------------------------S-------
---------T---------------------------------------------------------------------o----------------------------------------------S---------------S-------
--------TT--------!--T-----------------------!S--S-------------------S---------------S------------T-------------------------------TT----------SSSS----
--------TT---TT-----TT--------------------------------------U---T---------TT----------------------T-------------------------------TT--------TT--------
--------TT---TT----tTT-----------------------------------------TT---------TT----------------------Tt------------------------------TT--------TT--------
----g---TT---TT----tTT------k-----------k-g-----k-------y------TT--------gTT-------k-------k-k---gTt----------------g---k---k-----TT--------TT--------
XXXXXXX-XXXXXXXXXXXXXXXXXXXXXXXXXX--XXXXXXXXXXXXXXXXXXXXXXX--XXXXXXXXXXXXXXXXXXXXXXXXXXXXXXXXXXXXXXXXXXXXXX-XX--XXXXXXXXXXXXXXXXXXXXXXXXXXXXXXXXXXX-X-
XXXXXXX-XXXXXXXXXXXXXXXXXXXXXXXXXX--XXXXXXXXXXXXXXXXXXXXXXX--XXXXXXXXXXXXXXXXXXXXXXXXXXXXXXXXXXXXXXXXXXXXXX-XX--XXXXXXXXXXXXXXXXXXXXXXXXXXXXXXXXXXX-X-
