---------------------------------------------------------------------------------------------------------------XXXXX---SSSS----------g-----------g----
-----------------------------------------------------------------------------------------------------------------------SSSS--------SSSSSSSSSSSSSSSSSSS
-----------------------------------------------------------------------------------------------------------------------SSSS--------SSSSSSSSSSSSSSSSSSS
----------------------------------------------------------------------------------------------------------------------2S-SS--------SSSSSSSSSSSSSSSSSSS
---------------------------------------------------------------------------------------------------------------------------------g-SSSSSSSSSSSSSSSSSSS
-------------------------------------------------------------------------------------------------------------------------------XXXXXXXXXXXXXXXXXXXXXXX
-----------------------SSSSSS!!@---------------------------S-SSCSSCSSS--------------o------------------------y-----------------XXXXXXXXXXXXXXXXXXXXXXX
------------------------------------------------------------------------T----------------------------------###---SS-----------------------------------
------------------------------------------------------------------------T---@------------------------------###--------#####---------------------------
------------------------------------------------------------------------T---------------------------------####--------#####---------------------------
-----------------------------!S!-----------!--------------------------#-T------------------------KK------#####--------#####----SSSSSSSSSSSSSSSSSSSSSSS
-------------------#----------------TT--------------------------------#-|----------------TT-----------F--#####--SS#-##-#XXX-----SSS-SSSSSSSSSSSSSSSSSS
------------------F#----------------TT------y-------------F-----------#------------k---k-TT-k---------#--#####------#---XXX-----SSS-SSSSSSSSSSSSSSSSSS
-----------g------##--k----kk----g--TT--k---S----------k--#g----------#--XXXXXXXXXXX-XXXXXXXXXXXXXXXXXXXXXXXXX------#--------S--SSSoSSSSSSSSSSSSSSSSSS
XXXXXXXXXXXXXXXXXXXXXXXXXXXXXXXXXXXXXXXXXXXXXXXXXXXXXXXXXXXXXXXXXXXXXXX--XXXXXXXXXXX-XXXXXXXXXXXXXXXXXXXXXXXXX--g---#---------------------------------
XXXXXXXXXXXXXXXXXXXXXXXXXXXXXXXXXXXXXXXXXXXXXXXXXXXXXXXXXXXXXXXXXXXXXXX-----------------------------------------XXXXX--------------S------------------
