------------------------------------------------------------------------------------------------------------------------------------------------------------------------------------------------------------------------------------------
------------------------------------------------------------------------------------------------------------------------------------------------------------------------------------------------------------------------------------------
------------------------------------------------------------------------------------------------------------------------------------------------------------------------------------------------------------------------------------------
------------------------------------------------------------------------------------------------------------------------------------------------------------------------------------------------------------------------------------------
-------------------------------------------------------------------------------------------------------------------------------------------------------------------------------------------------------------------------------y----------
-------------------------------------------------------------------------------------------------------------------------------------------------------------------------------------------------------------------------------##---------
-----------------------------------------------------------------------------SUS---------------------------------------------------------------------------------------------------------------------------------------------y###---------
----------------------------------------------------------------------------------------------------------------------------------------------------------------------------TT-----------------------------------------------####---------
----------------------------------------------------------------------------------------------------------------------------------------------------------------------------TT-------------------oo-------------------------#####---------
-------------------------------------------------------------------------------------------------------------------------------------------------------------------#LSS-----##------------------o--o-----------------------######---C-----
----------------------------------------------------------------------------#####----------------------------------------------------------------------------------#------------------------------------------------------#######---------
----------------------------------------------------------------------------#--------------------------#--------------------------------------------------T--------#-----------B---TT------------------------------------########--------F
---------------------------------------------------------------------------K#---------------------B----#--------------------------------------------------T------kk#-----------b---TT------------------------y----------#########--------#
--M------------k------ggg------kkk---------kkk-------ggg-------ggg----------#--------------ggg----b----#----ggg--k----ggg------------------k-------ggg----TXXXXXXXXXXXXX---XXXXXXXXXX-X-X-XXXXXXXXXXXXXXXXXXXXXXXXXXXXXXXXXXXXXXXXXXXXXXXX
XXXXXXXXXXXXXXXXXXXXXXXXXXXXXXXXXXXXXXXXXXXXXXXXXXXXXXXXXXXXXXXXXXXXXXXXXXXXXXX----XXXXXXXXXXXXXXXXXX--XXXXXXXXXXXXXXXXXXXXXXXXXXXXXXXXXXXXXXXXXXXXXXXX--XXXXXXXXXXXXXXX---XXXXXXXXXX-X-X-XXXXXXXXXXXXXXXXXXXXXXXXXXXXXXXXXXXXXXXXXXXXXXXX
XXXXXXXXXXXXXXXXXXXXXXXXXXXXXXXXXXXXXXXXXXXXXXXXXXXXXXXXXXXXXXXXXXXXXXXXXXXXXXX----XXXXXXXXXXXXXXXXXX--XXXXXXXXXXXXXXXXXXXXXXXXXXXXXXXXXXXXXXXXXXXXXXXX--XX-------------------------------------------------------------------------------
