---------------------------------------------------------------------------XXXXXXXXXXXXXXXXXXXXXXXX#X----------1-----------t--#t----#--##--------C#ttt
--------------S----------------------------------------------------------------------------XXXXXXXXXX-------------#t---#--#t--#t----#--##--t------#ttt
---------------------------------------------------------------------------------------------------XX-------------#t---#--#t--#tM---##-##--t-t----#XX#
-------!--------------------!S------------------------------------------------------------------------------S-----#t---#XXXXXXXXXXXXXXXXXXXXXt--M-XXXX
------------t!--------S---------------------------------------------------------------------------------------#---#t---XXXXXXXXXXXXXXXXXXXXXXXXXXXX--X
------------t--------------------------------------------------------------------------------------------!----#-gXXXXXXX---------------------XXXXX----
------------t-------------------------------------------------------------------------------------------------#-XXXXXXX-------------------------------
------------t-F-------------S---#-----------------------------------------------------------------------------#-X-------------------------------------
----------XXXX#-t---------------#-------!------------------------S--------------------S-----------------------#--------------------------S------------
----------XXXXX-t#--------------#---------------------------#-------------------------------------------------#---------------------------------------
-------S------X-t#-------------##---------------S----------t#-----------------------------------------XXXXXXXX#-------------------------S-------------
---------#-----Xt#t------------##XXXXXXXXXX------#---------t#---------------------------#--S----------XXXXXXXXXX-------------S------S-----------------
---------#-----XXXt------------##XXXXXXXXX----Xg-#---M--k--t#--#-------g---t------------#---!-----------------XX-------S------S----------S------------
----#----#------XXX--------k-#-#X------------XXXXXXXXXXXXXXXXXXXXXXXXXXXXXXtt---F-------#------------t------------S--------------------------------#--
XXXXXXXXX#--------XXXXXXXXXXXX-XX----------XXX-XXXXXXXXXXXXXXXXXXXXXXXXXXXXXt---#------g#------------t--------------------------t-------#----------#--
XXXXXXXXXX---------XXXXXXXXXXX-X-----------XX------------------------------XXXXXXXXXXXXXXXX#gg---g---t----------------------t-@-t----#--#---------1#--
