----------------------------------------------------------------------------------------------------------
----------------------------------------------------------------------------------------------------------
----------------------------------------------------------------------------------------------------------
----------------------------------------------------------------------------------------------------------
----------------------------------------------------------------------------------------------------------
-----------------------------------------------------------------------------------------------k----------
-----------------------------US----------------------------------------------------------------##---------
----------------------------------------------------------------------------------------------###---------
---------------------------------------------------------------------------------------------####---------
--------------------------------------------------------------------------------------------#####---------
---------!!-----------------####--SSC------------------ooo-------##--#---------------------######---------
-----------------------y-#####----------------------------------###--##-------------------#######---------
--------------------y-######-----------------------------------####--###-#---------------########--------F
--M----------------#######------------------y-y---------------#####--######---------ggg-#########--------#
XXXXXXXXXXXXX--XXXXXXXXX------XX--XXXXXXXXXXXXXXXX--XXXXXXXXXXXXXXX--XXXXXXXXXXXXXXXXXXXXXXXXXXXXXXXXXXXXX
XXXXXXXXXXXXX--XXXXXXXXX------XX--XXXXXXXXXXXXXXXX--XXXXXXXXXXXXXXX--XXXXXXXXXXXXXXXXXXXXXXXXXXXXXXXXXXXXX
