-------------------------------------------------------------------------------------------------------------------------------------------------------------------------------------------------------------------------------------------------
-------------------------------------------------------------------------------------------------------------------------------------------------------------------------------------------------------------------------------------------------
-------------------------------------------------------------------------------------------------------------------------------------------------------------------------------------------------------------------------------------------------
-------------------------------------------------------------------------------------------------------------------------------------------------------------------------------------------------------------------------------------------------
--------------------------------------------------------------------------------------------------------------------------------------------------------------------------------------------------------------------------------------XX---------
--------------------------------------------------------------------------------------------------------------------------------------------------------------------------------------------------------------------------------------XX---------
-----------------------------------------------------SUS------------------------------------------------------------------------------------------------------------------------------------------------------SSS---@-------------C---XX---------
-----------------------------------------------------------------------------------------------------------------------------------------------------------------------------------S--------------------------------------------------XX---------
------------------------------------------------------------------------------------------------------------------#-------------------------------------------------------------------------------------------------------------------XX---------
--------------------------------------------------------------------------------tt-------------------------------##--oo------o----o-------------------oo---oo-------------------------------------------------------------------------XX---------
----------------------------------------------------#####-------------------TT--tt------------------------------###----------------------------------------------------------------------------------------C------!--------------SS---XX---------
----------------------------------------------------#-------------------TT--TT--tt-----------------------------####-----------------------------------------------------------------------------------------------------TT------------XX---------
-------------------------------------g-------------K#-------------------TT--TT--tt----------------------------#####----------------------#---#-------------------------------------#------------------------------------TT------------XX--------F
--M------k---ggg-------ggg-----------ggg------------#--------------ggg--TT--TT--tt-----k--ggg-----ggg------gg######--k-------------------#-k-#-----------------------k------ggg----#-------k----ggg-------gg-----K-K----TT--------k---XX--------X
XXXXXXXXXXXXXXXXXXXXXXXXXXXXXXXXXXXXXXXXXXXXXXXXXXXXXXX----XXXXXXXXXXX-XX--XX--XXXXXXXXXXXXXXXXXXXXXXXXXXXXXXXXXXXXXXXXXXXX---XX---XXXXXXXXXXXXXXXX-----X----XXXXXXXXXXXXXXXXXXX--XXX--XXXXXXXXXXXXXXXXXXXXXXXXXXXXXXXXXXXXXXXXXXXXXXXXXXXXXXXXXX
XXXXXXXXXXXXXXXXXXXXXXXXXXXXXXXXXXXXXXXXXXXXXXXXXXXXXXX----XXXXXXXXXXX-XX--XX--XXXXXXXXXXXXXXXXXXXXXXXXXXXXXXXXXXXXXXXXXXXX---XX---XXXXXXXXXXXXXXXX-----X----XXXXXXXXXXXXXXXXXXX--XXX--XXXXXXXXXXXXXXXXXXXXXXXXXXXXXXXXXXXXXXXXXXXXXXXXXXXXXXXXXX
