-------------------------------------------------------------------------------------------------------------------------------------------------------------------------------------------
-------------------------------------------------------------------------------------------------------------------------------------------------------------------------------------------
-------------------------------------------------------------------------------------------------------------------------------------------------------------------------------------------
-------------------------------------------------------------------------------------------------------------------------------------------------------------------------------------------
-------------------------------------------------------------------------------------------------------------------------------------------------------------------------------------------
-------------------------------------------------------------------------------------------------------------------------------------------------------------------------------------------
------------------------------------------------SUS-----------------------------------------------------------------------------------------------------------------------------##---------
--------------------------------------------------------------------------------------------------------------S-----------------------------------------------------------------##---------
------------------------------------------------------------------------------------------------------------------------------------------------------------------------------#-##---------
------------------------------------------------------------------------------------------------------------------------------------------------------------------------------#-##---------
-----------------------------------------------#####------------------------------------------------------------------------------------------------------------------------#-#-##---------
-----------------------------------------------#--------------------------#-------------------------------------------------------------------------------TT----------------#-#-##---------
----------------------------------------------K#---------------------B----#-----------------------------------#-------------------------------------------TT---------TT---#-#-#-##--------F
--M------------k------ggg-------ggg------------#--------------ggg----b----#----ggg--k----ggg-----------ggg----#-------k-----kkk-------kk------------kkk---TT---------TT---#-#-#-##--------#
XXXXXXXXXXXXXXXXXXXXXXXXXXXXXXXXXXXXXXXXXXXXXXXXXX----XXXXXXXXXXXXXXXXXX--XXXXXXXXXXXXXXXXXXXXXXXXXXXXXXXXX--XXX--XXXXXXXXXXXXXXXXXXXXXXXXXXXXXXXXXXXXXXXXXXXXXXXXXXXXXX-X-X-X-XXXXXXXXXXXX
XXXXXXXXXXXXXXXXXXXXXXXXXXXXXXXXXXXXXXXXXXXXXXXXXX----XXXXXXXXXXXXXXXXXX--XXXXXXXXXXXXXXXXXXXXXXXXXXXXXXXXX--XXX--XXXXXXXXXXXXXXXXXXXXXXXXXXXXXXXXXXXXXXXXXXXXXXXXXXXXXX-X-X-X-XXXXXXXXXXXX
