---------------------------------------------------------------------------------------------------------------------------------------------------------------------------------------------------------------------
---------------------------------------------------------------------------------------------------------------------------------------------------------------------------------------------------------------------
---------------------------------------------------------------------------------------------------------------------------------------------------------------------------------------------------------------------
---------------------------------------------------------------------------------------------------------------------------------------------------------------------------------------------------------------------
---------------------------------------------------------------------------------------------------------------------------------------------------------------------------------------------------------------------
------------------------------------------------------------------------------------------------g--------------------------------------------------------------------------------------------------------------------
---------------------LSSS---------------------!!!!!-------------------------------------------SSSSSSSS---SSS!--------------@-----------SSS----S!!S--------------------------------------------------------##---------
---------------------------------------------------------------------------------------------------------------------------------------------------------------------------------------------------------###---------
-----------------g---------------------------------------------------------------------------g----------------------------------------------------------------------------------------------------------####---------
-----------------#------------------------------k-----------------------------1------------------------------------------------------------------------------------------------------------------------#####---------
--------SUS-----##---2-----#-----------TT-----@!!!!--------------------tt------------------S@S--------------C-----SU----!--!--!-----S----------SS------#--#----------##--#------------SS!S------------######---------
---------------###---------#-----------TT------------------tt----------tt-----------------------------------------------------------------------------##--##--------###--##--------------------------#######---------
--------------####---------##----------TT------------------tt----------tt----------------------------------------------------------------------------###--###------####--###-----tt--------------tt-########--------F
--M----------#####----kk---##---gg-----TT------------gg----tt------g-g-tt------------------------------------g-g--------k-----------------gg-g-g----####--####----#####--####----tt---------gg---tt#########--------#
XXXXXXXXXXXXXXXXXXXXXXXXXXXXXXXXXXXXXXXXXXXXXXXXXXXXXXXXXXXXXXXXXXXXXXXXXXXXXXXXXXX--XXXXXXXXXXXXXXX---XXXXXXXXXXXXXXXXXXXXXXXXXXXXXXXXXXXXXXXXXXXXXXXXXXXXXXXXXXXXXXXX--XXXXXXXXXXXXXXXXXXXXXXXXXXXXXXXXXXXXXXXXXXXX
XXXXXXXXXXXXXXXXXXXXXXXXXXXXXXXXXXXXXXXXXXXXXXXXXXXXXXXXXXXXXXXXXXXXXXXXXXXXXXXXXXX--XXXXXXXXXXXXXXX---XXXXXXXXXXXXXXXXXXXXXXXXXXXXXXXXXXXXXXXXXXXXXXXXXXXXXXXXXXXXXXXX--XXXXXXXXXXXXXXXXXXXXXXXXXXXXXXXXXXXXXXXXXXXX
