--------------------------------------------------------------------------------------------------------------------------------------
--------------------------------------------------------------------------------------------------------------------------------------
--------------------------------------------------------------------------------------------------------------------------------------
--------------------------------------------------------------------------------------------------------------------------------------
---------------------------------------------------------------------------------------------------------------------------K----------
--------------------------------------------------------------------------------------------------------------------------------------
-----------------------------US--------------------------------------------------------------------------------------------##---------
--------------------------------------------------------------------------------------------------------------------------###---------
------------------------------------------------------------------------------------------------------------------------k####---------
-------------------------------------------------------B---------------------------------------------------------------g#####---------
---------!!-----------------####--SSC---------SS------S#2--------------------------------------------------K-----------######---------
-----------------------y-#####-------------------------------B----------------------------TT---------K---------------g#######---------
--------------------y-######---------------------------------b-----TT----K----TT----------TT-----TT-----K----B-------########--------F
--M----------------#######------------------y------B--y-y----b-----TT---------TT----------TT-----TT----------b------#########--------#
XXXXXXXXXXXXX--XXXXXXXXX------XX--XXXXXXXXXXXXXXXXXXXXXXXXXXXXXXXXXXXXXXXX-XXXXX-X------XXXXXXXXXXXXXXXXXXXX-X---XXXXXXXXXXXXXXXXXXXXX
XXXXXXXXXXXXX--XXXXXXXXX------XX--XXXXXXXXXXXXXXXXXXXXXXXXXXXXXXXXXXXXXXXX-XXXXX-X------XXXXXXXXXXXXXXXXXXXX-X---XXXXXXXXXXXXXXXXXXXXX
