------------------------------------------------------------------------------------------------------------------------------------------------------
----------------------------------------------------------------------------------------------------------------SSSSS---------------------------------
------------------------------------------------------------------------------------------------------------g-----------------------------------------
------------------------------------------------------------------------------------------------------------#SS------o--------------------------------
-----------------------------------------------------------------------------------------------------------##--!-----S-SS-----------------------------
-------------------------------------------------#---------------------#----------------------------------###------T---------------------#------------
------------------S----------------------------------!-----------------#---------------------------------####--1---TT-------------------##--------T---
----------------------------------------------------------------------###----#---------------------------####SSS---TT---o---------##---###-##-----T---
--------------------y------------------------------------------------####----#------------------------#-#####----S-TT-@!S--------#####-######---F-TT--
-----------------!2-------S------------------------------------------####---##------------------------#######------TT-----TT---#######-######--g#-TT--
------------------------------------------#-y------@-!--!------K---#######-###---------------t-------########------TT-----TT--F#####-#-XXXXXXXXXXXXXXX
------------------------------------------##-----------B-----------######-####--------------tt------y#XXXXXXXXXX--kTT-----TT--######-X-XXXXXXXXXXXXXXX
----------g-K-------r-----------------T---##--B--------*-----------######-####--------------tt--X#--#XXXXXXXXXXXXXXXXXXXXXXXXXXXXXXX-X----------------
----g----XXXXXXXXXXXX--k-----g------gTT---##--b---U---gB-----------######-####--k------k--g-tt--#---XX----------XXXXXXXXXXXXXXXXXXXX------------------
XXXXXX---XXXXXXXXXXXXXXXX-XXXXXXXXXXXXXXXXXXXXXXXXXXXXXXXXXXXXXXXXXXXXXXXXXXXXXXXXXXXXXXXXXXXXXXX---X-------------------------------------------------
XXXXXX---------------XXXX-XXXXXXXXXXXXXXXXXXXXXXXXXXXXXXXXXXXXXXXXXXXXXXXXXXXXXXXXXXXXXXXXXXXXXXX-----------------------------------------------------
