----------------------------------------------------------------------------------------------------------------------------------------------------------------------------------------------------------------------------------------------------------------------------------------------------------------------------------------------------------------------------------------------------------------
----------------------------------------------------------------------------------------------------------------------------------------------------------------------------------------------------------------------------------------------------------------------------------------------------------------------------------------------------------------------------------------------------------------
----------------------------------------------------------------------------------------------------------------------------------------------------------------------------------------------------------------------------------------------------------------------------------------------------------------------------------------------------------------------------------------------------------------
----------------------------------------------------------------------------------------------------------------------------------------------------------------------------------------------------------------------------------------------------------------------------------------------------------------------------------------------------------------------------------------------------------------
-------------------------------------------------------------------------------------------------------------------------------------------------------------------------------------------------------------------------------------------------------------------------------------------------------------------------------------------------------------------------------------TT-------------------------
-------------------------------------------------------------------------------------------------------------------------------------------------------------------------------------------------------------------------------------------------------------------------------------------------------------------------------------------------------------------------------------TT-------------------------
-----------------------------US-------------------------------SS!SSS@SSS--------SSC-----------------------------------------------------------------!--------------------------------------!-!--------------------------------------USSS------------------------------------SSS!------------------------------------------------------------------------------------------------2----##-------------------------
------------------------------------------------------------------------------------------------------TT----------------------------------------------------------------------------------------------------------------------------------------------------------------------------------------------------------------------------------------------------o-------@-------------------------------------------
------------------------------------------------------------------------------------------------------TT-----------------------------------------------------------------------------------------------------------------------------------------------------------------------------------------------------------------@--------------------------------------------------------------------------------------
----------------------------------------------------------------K---------------SSS-------------------TT-------------------------------------------------------------oo------------------------------------------------------------------TT--------------------------------------------------------------B---------------------------------------oooo----------------------------2------------------------------
--------S!!-----------------####--SSC-----------------TT------SSSSSSSSSSS-----------------##--#-------XX-----TT-------TT---------------g##--------------------------o--o-------------------!-!-----------------------------------TT------TT-----------------------------C-------------U---------SS------S#2---------------------------ooo------------o--------------C--------------------------------oo---------
-----------------------y-#####------------------------TT---------------------------------###--##-------------TT-----TTTT----TT---------###------TT--------------------------------------------------------------------K----------TT--tt--TT----------------------#----------------------------------------------------------------------------------------------TT---------------------------------------TT-----
--------------------y-######--------------------------TT--------------------------------####--###------------TT---TTTTTT----TT--------#####-----TT------------------K---------------------------------------------------B--------TT--tt--TT------------------K---#-------------------------B-----------------------------#--------------------------------------TT---#----tt-----------------#-----------TT-----
--M----------------#######------------------y-y-------TT--------------K----------------#####--####----#------TT---TTTTTT----TT-------######-y---TT-------------------------------y-------------y------------------------b-ggg-----T--tt--TT-----k----------------#-----gg-------g-g--------b--y------B--y-y----g-----T---#-------k-kkk----kk----------kkk-------kTk--#----tt---r-------------#----kk-----#T-----
XXXXXXXXXXXXX--XXXXXXXXX------XX--XXXXXXXXXXXXXXXXXXXXXXXXXXXXXXXXXXXXXXXXXXXXX----XXXXXXXXX--XXXXXXXXXXXXXXXXXXXXXXXXXXXXXXXXXXXXXXXXXXXXXXXXXXXXXXXXXXXXX--XXXXXXXXXXXXXXXXXXXXXXXXXXXXXXXXXXXXXXXXXXXX----XXXXXXXXXXXXXXXXXXXXXXXXXXXXXXXXXXXXX---XXXXXXXXXX--XXXXXXXXXXXXXXXXXXXXXXXXXXXXXXXXXXXXXXXXXXXXXXXXXXXXX---X--XXXXXXXXXXXXXXXXXXXXXXXXXXXXXXXXXXXXXXXXXX----XXXXXXXXX----------XXXXXXXXXXXXXXXXXXX
XXXXXXXXXXXXX--XXXXXXXXX------XX--XXXXXXXXXXXXXXXX-XXXXXXXXXXXXXXXXXXXXXXXXXXXX----XXXXXXXXX--XXXXXXXXXXXXXXXXXXXXXXXXXXXXXXXXXXXXXXXXXXXXXXXXXXXXXXXXXXXXX--XXXXXXXXXXXXXXXXXXXXXXXXXXXXXXXXXXXXXXXXXXXX----XXXXXXXXXXXXXXXXXXXXXXXXXXXXXXXXXXXXX---XXXXXXXXXX---XXXXXXXXXXXXXXXXXXXXXXXXXXXXXXXXXXXXXXXXXXXXXXXXXXXX---X--XXXXXXXXXXXXXXXXXXXXXXXXXXXXXXXXXXXXXXXXXX----XXXXXXXXX----------XXXXXXXXXXXXXXXXXXX
