---------------------------------------------------------------------------------------------------------------------------------------------------------------------------------------------------------------------------------------------------------------------------------------------------------------------------------------------------
---------------------------------------------------------------------------------------------------------------------------------------------------------------------------------------------------------------------------------------------------------------------------------------------------------------------------------------------------
----------------------------------------------------------------------------------------------------------------------------------------------------------------------------------------------------S----------------------------------------------------------------------------------------------------------------------------------------------
---------------------------------------------------------------------------------------------------------------------------------------------------------------------------------------------------------------------------------------------------------------------------------------------------------------------------------------------------
----------------------------------------------------------------------------------------------------------------------------------------------------------------------------------------------------------------------------------------------------------------------------------K----------------------------------------------------------------
-----------------------------------------------------------------------------------------------------------------------------------------------------------------------------------------------------S------------------------------------------------------------------------SSSSSS----1-----------------------------------------------##---------
---------------------LSSS---------------------!!!!!-----------------------------USSS--------!!!!!-----------USSS--------SSCSS------SSSS-------------------------------------------------------------------------------------------------------------------------------------------------------------------------------------------------##---------
---------------------------------------------------------------------------------------------------------------------------------------------------------------------------------------------------T------------------------------------------------------------------------------------------------------------------------------------##---------
-----------------g---------------------------------------------------------------------------------------------------------------------------------------------------------------------------------T-------------------oooo----------------------------------------------------K-------------------------------------------------K---#--##---------
-----------------#------------------------------k------------------------------------TT-------k-----------------------------------------------g----------------------------------------------------T-S---------------------------------------##----------------------TT------SSSSSSS------------------------------------------------##--##---------
--------SUS-----##---2-----#-----------TT-----@!!!!-------TT-----------------TT------TT-----@!!!!----------S-----TT---!!!!--!!!---------------TT-------------------TT-------TT------------tt------SXS---#----TT----------------K-------------###---------------------TT-----------------TT--------------TT-------------------------###--##---------
---------------###---------#-----------TT-----------------TT----------g------TT--tt--TT--------------------------TT---------------------------TT----------g--------TT-----TTTT----TT------tt------------#----TT---------------------K--------####--------------------TT-----------------TT---------B----TT----TT-----B------------####------------F
--------------####---------##----------TT-----------------TT----------TT-----TT--tt--TT--------------------------TT---------------------------TT----------TT-------TT---TTTTTT----TT------tt-TT---------#----TT------kk-----------------#----#####-----------ggg-----TT-----------------TT---------b----TT-k--TT-----b-----K-----#####------------#
--M----------#####----kk---##---gg-----TT------------ggg--TT----------TT--g--TT--tt--TT------------gg----k-ggg---TT------------ggg------------TT----------TT--g----TT---TTTTTT----TT------tt-TT------XXXXXX--TTXXXXXXXXXXXXXXXXXXXXXXXXXX----XXXXXX---XXXXXXXXXXXXXXXXXXXXXXXXXXXXXXXXXXXXXXXXXXXXXXXXXXXXXXXXXXXXXXXXXXXXXXXXXXXXXXXXXXXXXXXXXXXXX
XXXXXXXXXXXXXXXXXXXXXXXXXXXXXXXXXXXXXXXXXXXXXXXXXXXXXXXXXXXXX---XXXXXXXXXXXXXXXXXXXXXXXXXXXXXXXXXXXXXXXXXXXXXXXXXXXXXXXXXXXXXXXXXXX----XXXXXXXXXX---XXXXXXXXXXXXXXXXXXXXXXXXXXXXXXXXXXXXXXXXXXXXXXXXXXXXXXX--TTXXXXXXXXXXXXXXXXXXXXXXXXXX----XXXXXX---XXXXXXXXXXXXXXXXXXXXXXXXXXXXXXXXXXXXXXXXXXXXXXXXXXXXXXXXXXXXXXXXXXXXXXXXXXXXXXXXXXXXXXXXXXXXX
XXXXXXXXXXXXXXXXXXXXXXXXXXXXXXXXXXXXXXXXXXXXXXXXXXXXXXXXXXXXX---XXXXXXXXXXXXXXXXXXXXXXXXXXXXXXXXXXXXXXXXXXXXXXXXXXXXXXXXXXXXXXXXXXX----XXXXXXXXXX---XXXXXXXXXXXXXXXXXXXXXXXXXXXXXXXXXXXXXXXXXXXXXXXXX----------------------------------------------------------------------------------------------------------------------------------------------
