-----------------------------------
-----------------------------------
-----------------------------------
-----------------------------------
-----------------------------------
-----------------------------------
------------------------##---------
------------------------##---------
------------------------##---------
------------------------##---------
-------SSS------------#-##---------
----------------------#--#---------
----------------TT----#-----------F
--M-----------k-TT----#-----------#
XXXXXXXXXXXXXXXXXXXXXXXXXXXXXXXXXXX
XXXXXXXXXXXXXXXXXXXXXXXXXXXXXXXXXXX
