---------------XX------------------------------------------rX-XX----------------------------------------------------------r---r----------------------r---------r----r---------------------------------r-----------------------------2----S-r--------------r------b------##----##---------------------r-----#-kkk--XXX----TT----------g------kr-r----##--##-------------------TT---------------------------------
---------------------------------r---------------------------------------------------------------------------------------------------------------kSSSSS----------------------------T------------------------------------------------------SSSS--r-t-------------XXXr----###--###------r-------rkkkXX-XXXXXXXXXXXXXXXXXXXXXX-----rr-gXXXXXXXXXX--X#####-----------------------TT-----------------------------r-SS
-------------------------------------------------------------------r----------------------------------------------------------------------------SS-------------r------------------rT--------------------------S----r--------------------#---------t#---r---r-rrXXXX-r---###--###--------rX-XXXXXXXXX-XXXXXXXXXXXXX---XXXXXXr-XXXXXXXXXXXXXXXXX--XX-###-----------gg---r--r---TT-------r-----------------------r-
----------------------------------------------------------------------------------r---------r------------------------------------------------------------------r------------------T----------------------------@-----------r------------#-------XXXXXX-XXXXXXXXX--------######XXXXXXXXXXXX-XXXXXXX---------------------------XXXXXXX-------------X-XXXXXXXXXX-XXXXXXXXXXXXXXXXT----r-----gT--------X------------
-----------------r---------------r-------------------------------------------------------------------------------r-------S----------2----------------k-r-----------------------r--T---r---B------------------------------r--------r---rX--------XXXXXX-XXXXXXXX---------XXX##XXXXXXXXXXXX---------------------------r----------------------r-----X-XXXXXXXXXX-XXXXXXXXXXXXXXXXXXXX-XXXXXXX---XXXXXXX---------r--
-------------------------r--r-----------------------------------r-----------r---------US---r---------------------------------------------------------CC@--------------------------T----rr-b--g----------B----------r-----XXXXXXXXXXXXX-X--------------------------------XXXXXX--------------------r--r-----r-r-------r--------------------------------------------------------XXXX-XXXXXXX---XXXXXX-------------
----------------------------2-------------------------------------------------------r------------------------r----------r------------------@@-D----------------------------XXXXXXXT---XXXXXXXX-------r--b-ggg--------r-XXXXXXXXXXXXXXX---r-------------------------r-------XX------------r-r--------r-----------------------------r-----------------------------------------------------------------------------
--------------------------------------------r--------r----------------------r----r------------------------------------g#-------------2----------------------r------r------XXXXXXXXXX-XXXXXXXXX---XXXXXXXXXXXXXXXXXXXXXXXX---------------------------------------------------------------------------r-------------r----------------------------r-r-------------------------------------------------r--------r---
--------------r------------------------------------------------------------------------------------##--#--------------##-------------------------------r-rrr---rkXXX---XXXX-------XX-X-----------XXXXXXXXXXXXXXXXXXXXXX----------------r--------------------------r----------------------r--------------------r---------------------r-r-------r-------------------------------r-r-------------------------------
---------------------------------------------------TT---------------r----------------####-----r---###--##-----------g###----------K-----g--rk-----XXXXXXXXXXXXXXXXXX---XXX-------------------r---------------------------r-------------------------------------r----------------------------r-----r--------------------------r----------SS-----S-------------r------r---------------------r--------------------r
-----------TT----------------@----------TT---------TT-r-----r---------r-----------#####----------####--###----------####--r---r--------XXXXXXXXXXXXXXXXXXXXXXXXXX---------------------r--------------------------------------------------------------r--------------------------rr---K----rrSSS---------r-------------------------rr------------------------r----------r----------r--------------------SSS------
-----------TT---------------------------TT---------TT------TT-------B-----------#-###-----------#####--####------r-#####---rrr-----r---XXXXXXXXXXX---------------------------r----r----------------------------------r-------------------------------------------------------------SSSS-----------------------------------------------r------T-----------##----SS----------------r----------r---------S-------r-
-----------TTr----------------------yr--TTk---rrr--TT------TTr------b-----------#-#----------X-XXXXXX--XXXXX----XXXXXXXXXXXXXXXXXXXXXXX-----------------------------------r-------------------r-----------------------------rr------------------r----------S----------------------------S-------------------------------------------------r--Tr----------##-------------------------------r----------------rS---
--M--r--r--TT-----------r--r-r----XXXXXXXXXXXXXXXXXXXX----TTT-------B-g----rr---#-#----XX--XXX-XXXXXX--XXXXX----XXXXXXXXXXXXXXXXXXXXXXX-----------------------------------r--------------------r-----------------------r----r-------2-----------------------------r--------r-----------S------------------------------------------------SSS--X-----------##--------------------------------------------------S--
XXXXXXXXXXXXXX----XXXXXXXXXXXXX---XXXXXXXXXXXXXXXXXXXX-X--TXXr--KXXXXXXXXXXXXX-X-X#----XX--XX-r----------------------------------------r----------------------------r------r-------------------!--------r-------r-----rr------------------r-------------------------------------#-----------S---------------------------------------------------------#--##------------------------------------------#S---------
XXXXXXXXXXXXXX--XXXXXXXXXXXXXXX------------------------X--TXXX-XXXXXXXXXXXXXXXrX-X-------------------------------------------------------------------------------r-------------------------------------------r--!-------------------------------------------@-----B-r----------##--SSSS-r@------------------#---r----r----TT------------------r------##--##----S--------------T---------------------rr--------S-
