-----------------------------------------------------------------------------------------------
-----------------------------------------------------------------------------------------------
-----------------------------------------------------------------------------------------------
-----------------------------------------------------------------------------------------------
-----------------------------------------------------------------------------------------------
-------------------------------------------------------------------g----------------k----------
---------------------LSSS-------------------------------SSCCCCCCCCSSSS--------------##---------
-----------------------------------------------------------------------------------###---------
-----------------g-------------------------------------------------------#--------####---------
-----------------#-------------------------1----------------------------##-------#####---------
--------SUS-----##---2-----#-----------TT-----------------@SSSSSSSSSS--###------######---------
---------------###---------#-----------TT-----------------------------####-----#######---------
--------------####---------##----------TT----------------------------#####----########--------F
--M----------#####----kk---##---gg-----TT-----gg--------------------######---#########--------#
XXXXXXXXXXXXXXXXXXXXXXXXXXXXXXXXXXXXXXXXXXXXXTTXXXXXX---XXXXXXXXXXXXXXXXXXXXXXXXXXXXXXXXXXXXXXX
XXXXXXXXXXXXXXXXXXXXXXXXXXXXXXXXXXXXXXXXXXXXXTTXXXXXX---XXXXXXXXXXXXXXXXXXXXXXXXXXXXXXXXXXXXXXX
