--------------------------------------------------------------------------------------
--------------------------------------------------------------------------------------
------------------------------------------k-------------------------------------------
--------------------------------------------------------------------------------------
--------------------------------------------------------------------------------------
-------------------------------------kr-----------------------------------------------
---------------SSC------------------S!S--S!S--------------------------------#---------
---------------------------------------------------------------------------##---------
----------------r---------g#---------------------------------#-----------k###---------
---------------SSS-------g##---------------k-----------kk----#--S--------####---------
-----SSS-----------------###--------S!S--S@S--------SCSSS----#-----------####---------
------------------------####--------------------------K-----##---------######S--------
----k----------------r-#####--------------------------------##--------#######--------F
--M-------------------######------k------gkg--------K---k---##-------########--------#
XXXXXXXXXXXXXX----XXXXXXXXXX--XXXXXXXXXXXXXXXXXXXXXXXXXXXXXXXX---XXXXXXXXXXXXXXXXXXXXX
XXXXXXXXXXXXXXX---XXXXXXXXXX--XXXXXXXXXXXXXXXXXXXXX-XXXXXXXXXX---XXXXXXXXXXXXXXXXXXXXX
