-----------------------------------------------------------------------------------------------------------------------------------------------------------------------------------#----kk-----#------TT-----r----gg------------#########--------#-
-----------------------------------------------------------------------------------------------------------------------------------------------------------------------------------XXXXXXXXXXXXXXXXXXXXX--XXXXXXXXXXXXX--------XXXXXXXXXXXXXXXXXXX-
-----------------------------------------------------------------------------------------------------------------------------------------------------------------------------------XXXXXXXXXXXXXXXXXXXXX--XXXXXXXXXXXXX--------XXXXXXXXXXXXXXXXXXX-
---------------------------------------------------------------------------------------------------------------------------------------------------------------------------------------------------------------------------------------------------
---------------------------------------------------------------------------------------------------------------------------------------------------------------------------------------------------------------------------------------------------
--------------------------------------------------------------g----------------------------------------------------k-------------------------------------------------------------------------------------------------------------------------------
------------------SCS-----------------------------------------SSSSS-----SSSSS---------------------------------S---SSSSSSSSS------------US---SS-----------------------------------------------------------------------------------------------------
---------------------------TT-----------------------------------------------------------------------------TT-------------------------------------------------------------y-------------------------------------------------------------------------
---------------------------TT----------------------------TT-----------------------TT----------------------TT-----------------------------------------------------------#SS-------------------------------------------------------------------------
---------------------------XX----------------------TT----TT-----------------------TT----------------------TT-------------------------SS-------------------------------##---------------------------------------------------------------g##---------
-----SSS------TT---2---TT----------------TT---SU---TT----XX------------------2----TT-------------tt------SXXS------------------------------SSS--------TT-------------###--S-----------------------------------------------------------g###---------
--------------TT-------TT-------------K--TT--------TT----------------------TT-----TT-----TT------tt-----------------------------------------------#-TTTT------------####---S---------------------------------------------------------g####---------
--------------TT-------TT-----TTTT-------TT--------TT---------TT-----tt----TT--TT-TT-----TT------tt-TT--------TT--------------TT--TT-------------##-TTTT-----------#####----SS------------------------------------------K------------#####---------
--M-----------TT----k--TT-----TTTT-------TT------k-TT---------TT-----tt----TT--TT-TT---k-TT------tt-TT--------TT--------------TT--TT------------###-TTTT------ggg-######--------------------oo---------------------------###-----#--######---------
XXXXXXXXXXXXXXXXXXXXXXXXXXXXXXXXXXXXXXXXXXXXXXXXXXXXXXXXXXXXXXXXXXXXXXXXXXXXXXXXXXXXXXXXXXXXXXXXXXXXXXXXXXXXXXXXXXXXXX------XXXXXXXXXXXX-X-XXXXXXXX-XXXXXXXXXXXXXXXXXXXX------------------------#----------------------------------#######---------
XXXXXXXXXXXXXXXXXXXXXXXXXXXXXXXXXXXXXXXXXXXXXXXXXXXXXXXXXXXXXXXXXXXXXXXXXXXXXXXXXXXXXXXXXXXXXXXXXXXXXXXXXXXXXXXXXXXXXX------XXXXXXXXXXXX-X-XXXXXXXX-XXXXXXXXXXXXXXXXXXXX------------#-----------#------TT-------------------------########--------F
