--------------------------------------------------------------------------------------------------------------------------------------------------------------------------------------------
--------------------------------------------------------------------------------------------------------------------------------------------------------------------------------------------
--------------------------------------------------------------------------------------------------------------------------------------------------------------------------------------------
--------------------------------------------------------------------------------------------------------------------------------------------------------------------------------------------
--------------------------------------------------------------------------------------------------------------------------------------------------------------------------------------------
------------------------------------------------------------------------------------------------------------------------------------------k---------------------------------------k---------
---------------------------------------------------------------------1-------USS------------------SS!SSS@SSS--------SSC------------------S!S--S!S--------------------------------##---------
--------------------------------------------------------------------------------------------------------------------------------------------------------------------------------###---------
-------------------------------------------------------------------------------------------------------------------------------g#---------------------------------#-----------k####---------
---------------------------------------------------------------------ggg----------------------------K---------------SSS-------g##---------------------------k-----#-----------#####---------
---------!!--------------TT---------------------S--------------##########---#-------------TT------SSSSSSSSSSS-----------------###--------S!S--S@S--------SCSSS----#----------######---------
-------------------TT----TT-----------------TT----------------##--------#---#-------------TT---------------------------------####--------------------------K-----##---------#######---------
-------------------TT----TT-----------------TT--------TT-----###--------#---##------------TT--------------------------------#####--------------------------------##--------########--------F
--M----------------TT---gTT--------------gggTT------k-TT----####--------#---##--gg----k---TT--------------K----------------######------k------ggg--------K---K---##-------#########--------#
XXXXXXXXXXXXX--XXXXXXXXXXXXXXXXX---XXXXXXXXXXXXXXXXXXXXXXXXXXXXX--------X---XXXXXXXXXXXXXXXXXXXXXXXXXXXXXXXXXXXXXXX----XXXXXXXXXX--XXXXXXXXXXXXXXXXXXXXXXXXXXXXXXXX---XXXXXXXXXXXXXXXXXXXXXX
XXXXXXXXXXXXX--XXXXXXXXXXXXXXXXX---XXXXXXXXXXXXXXXXXXXXXXXXXXXXX--------X---XXXXXXXXXXXXXXXXXXXXXXXXXXXXXXXXXXXXXXX----XXXXXXXXXX--XXXXXXXXXXXXXXXXXXXXXXXXXXXXXXXX---XXXXXXXXXXXXXXXXXXXXXX
