----------------------------------------------------------------------------------------
----------------------------------------------------------------------------------------
----------------------------------------------------------------------------------------
----------------------------------------------------------------------------------------
----------------------------------------------------------------------------------------
----------------------------------------------------------------------------------------
-----------------------------US---------------------------------S!-----------##---------
----------------------------------------------------------------------------###---------
-------------------------------------------------------------g------------g####---------
-------------------------------g---------------------------------------g-y#####---------
--------S!!----------------g####--SSC----------------------------!S------######---------
-----------------------y-#####----------------------------SSS----------g#######----g----
--------------------y-#####k------------------------C@-----------------########--------F
--M----------------g#g####------k-g---------y-y--------g----g------ggg#########--------#
XXXXXXXXXXXXX--XXXXXXXXX------XX--XXXXXXXXXXXXXXXXXXXXX-----k-XXXXXXXXXXXXXXXXXXXXXXXXXX
XXXXXXXXXXXXX--XXXXXXXXX------XX--XXXXXXXXXXXXXXXX-XXXX-------XXXXXXXXXXXXXXXXXXXXXXXXXX
