-------------XXXXXXXXXXXXXXXXXX-##---##XXXXXXXXXXXXXXXXX-------###--XX-----------------TT---------------------------------------------TT--------------
--------------------------------XX-####XXXXXXXXXXXXXXXXX-XXXXXXXXX-----------XXXXXXXXXXXX---------------------------------------------TT--------------
--------------------------------XX-####------------------XXXXXXXXX-------S---XXXXXXXXXXXX----------------------#----o-----2-----------TTk------o-----g
-----------------------------------####------------------------------------------------------------------------#----#----!----------XXXXXXXXXXXXXXXXXX
-----------------------------------####------------------------------------------------------------------------#----------------T---XXXXXXXXXXXXXXXXXX
-----------------------------------XXXX-------------------------------------S----------------------------------#------F----#----T---------------------
-----------S-----------------------XXXX----------------------------------@!S-----------------------------------B---kk-#--g-#----T---------------------
-------------S----------------#---------------------------------------------K---------------------------------#XXXXXXXXXXXXXXXXXXX--------------------
---------T--------------------#---#-----------------SS-----y--------------------------------------------------#XXXXXXXXXXXXXXXXXXX--------------------
--------TT----------------y##b##-##------------------------S!-U!-------------S--S!SS--------------------#----##---------------------------------------
--------TT----------------######-##-------------------------------------XXXXX-----------------K---------#-#####---------------------------------------
--------TT----T---------########-##-------------------------------y--##-XXXXX-------o-------------------#######----------------------------1SS-SSo----
--------TTt---T---------########-##---------------S-2-2----K------#--##--------oK---C-------------------#######---------------------------------------
-------rTT|---Tt--------########-##o----y------------------SKS-@###--##SS-------#S!SS------XXXXXXXXXXXXXXXXXXXX----------------------------------S----
XXXXXXXXXT|-S-Tt--------########-##-----#F----------------------###--##-----------------TT-XXXXXXXXXXXXXXXXXXXX-------------------------------SSoS----
XXXXXXXXXXX---XXXXXXXXXXXXXXXXXX-##---gy##----g-y---------------###--XX-----------------TT---------------------------------------------TT--!-SS---S---
