------------X-XXXXXXX-XX----X-------X--XX------------------------------------------------g---------------------------------SS----------------------S--
-------------X-X---------------------------------X----------------------------------------------------------------------------------------K-----------
-----------------------------------------------------------------------------S-------S-------!----------------S----------------------------2-----#----
-----------------------------------------------------------------------------------------------------S----------------U-------------------------------
----------------------------------------------------S-------------------------------------------------t----!---S----------------------------------T---
------S!-------------------------------------------------S----------------------------------------------------T-------t#-------------------#----------
---------------------------------------------------------------S--------------t---------------------------T-T---------------------------#g-XXX-XXXX--X
-------------S------------C-------U--------S---------S---S----------------------------------------------------#---------gg--X--g------XX--X-XXXXXXXX-X
----------------------S--------------------------S-----------------------------K-------------T------X--X---XXXXX-----XXXXXXXXXXXXXXXXXXXXXX-X-----X---
----------------------------------!------2------------------------S----------#------Xg---X---X--X--X--XXX-XXXXXXXXXXXXX--XX--XX--XX-------------------
------------S-----------S-----t-----------F----------!-------------#---t--------XXXXXXXXXXXXXXXXXX-XX--X-------XXXXX----------------------------------
------------------------S----------------------#-------------------t-------tX-XXX-XXXXXXX-XXXXX-------------------------------------------------------
----------t-Tt--------------T-----------------------t#-#-----g#-------XXXXXXXXXXXX------------C-------------------------------------------------------
------g------#--------2------k----XX--T------t--!---#X--X#tXg-XXXXXXXXXXXXX------------------------------------------------------------------S--S-----
XXXXXXXXXXX--X-----#------X--X-XXXXXXXtXXM--XXXXXX-XXXX-XXXXXXXXXXX-X-----------------------------------------------S---------------------------------
XXXXXX!X-XX-XXXXXt--XXXXXXXXXXX-XXXXXXXXXXXXXD-----XXX--XX-------------------------------------------------------------#----------------------S-------
