------------X--XXX--#--XXXtXXX--X*XXXXXXXXXXX-XgXXXXXX-XXXXXXX--XXXX--XXXXX-X-XX#X#XXX#-XXXXXXXSX--XXXXXXX--XXX-XX---XXX#X@XXX!--XYXT---Xk--X----#--S-
----------#-------XX--!-XX-XXXX-#-XXXX-------g--X-XXX-X----------------------X-XgXXXX--XXXXX----------XXX-XX-XX-XX-XXXXXX---XXXXXXXXX-XXtX-XX#--X--#--
--------------------------X--------U--------------X--------X--------------------X--X!---X----------------X--XX-XXX--X--X---g-XXt#XXXXXXXXX#--X#X-XXXXX
----------------------------------------------------------------g-------------------g---------------------------XX-------------------#XXXX--X---XXXX--
--------------------------------------------------------------------------------------------------------------S-------------------------------#-----X-
----------------------------------------------------------------g----------------------------------------#-----------------L--------------------------
-------------------------------------------------------------------------------------TF-------------------------------o---------------------g---------
------------------------------------------------------------T-----------------------------------------------------------------------------------------
-------------------------------------------------S----------------------------------#-g---------------------------------------------S-----------------
-----------#-------------------------------------------X---------------------------------------T----S-------------------------------S-------#---------
--------------#--S-------S----------------!----------S-T---------------L--------------S--------------#C-------------------------------------S---------
---------!----------S----M--------t-------#--#---g--------S---------T---#----------2---#----X---------t----------------------------------------T------
------T-#---k----T--X-------XT--------UST-#---2---S---------S----XX-----XT-------X---------g-----S-----------#------------T-#--------------#-------X--
----XXXXT#-XX--------##--T-------#---------------#R-T--#--@--#-S-#---#-TL-TLS---------g----#-g----#------#---------!-#-----#------St-----#------------
XXXXXXXXXXX-X-TX-#--g-tX-XX#-T----Sgt-XXXXXXXXX--o---TX--XGXXXX--XX-SXXXXX-----t---M---------X--XXXXXX!--#T------#------gX----X#------S---t-St-------S
XXXXX-XX-XXXXXXX*X---X-XXX-XgXC-X---#--X-X-XXX#-X#XX-rXTX-XXX--X--XX*-XXXXXXX--X--#X##-----gXXXXX-XXGXXXXXX-----X------tXXK--t---X-T----------T--!----
