---------X---------------1----y--------X---------------S----#-X-X--!---#--#-------X-----T--------X-X-2-----------XX-C------XX---X-----------y---C--X--
-------g--X--XXX--------2X-----------S-!---M---G------@-X------------------X-X-#---------X--X------X----K----X---X---------X-----#--X------------KXC--
-------X-X---R--------X------------X----X-----X----XX------X--------------#X----X--X#-X--X----X--------S-------X-X-XX------X#-2---g--X---L--C-X-------
----------X---2----X-------1--XXXXU---X---X-------XXX--X-XX-----2X-X-----CX-X-----------X--XX------X-----X---------!---------S--X---#--------X--------
-------2-T---------------X------X----rS------X----X--------XX--X------X------C----D--------X-X---------X-C-X--X----------X-------XX--o-!--------------
-------X------X-X---------------SS-XX----X-----g-------X--XX-X------------XX----X-oX-------rF-------X-MX---X-----------X-XX----T-------g---------X----
-----X---L---------L-#--XX---X---XL----------XXX----------X----YX-----X---------------X-------------X-t--X----------------X----G----------1---XX------
-------G-----------%---G--t--X---M---X---------------X-----X----XX-X---X-TX-------X---Xk-#----o---#------X---------2-X--------------#-----X-----------
-------------------S---#---X--gX--------X----!-----2------------X#X--X-X---------XD------X---------#X---X------------------------#--------X#X---------
------X------X--------------K----g-X-X---r----X---X---X------X------S-T---L-----S---X--X-----------X----------------------------------X----X----------
--------------tXU------X--------X---------X-y-----*--------X--------------F-----#---------X-X---X--t----X------X---XXX----X-----------X------X--X-X-X-
-------------2--------------X---X--2----#----L2------------------X----X----X---------S--------X-------X---XX--------X------XX--X------1---X-----------
----X-------#--------X-X---------------------X-X-X------------------#-X-XX-*--------XX--C--------X------------X---X----r-X----X--------X-------------X
--------S|-X------------------XX---y#-----------------Y----------X-------F------------X-----2----#--X----Xg--L-----X#-----X--X-X---------X------k-----
XXXXX--X---------X-XY----X---X----X-#-S----D----------------X-X-------L------X-2----------------S-----------------#--------------Xr----------XX---XX--
XXXXX----XU-----------%-XXX---------------------XX--------X---X-----#---X--1-----g-------X--y-----------*-----%------*-----XX-------Y--#---XS--------@
