-----------------T##---###-####---------#--#-##X#----#---------S-----------k-###--------------------------------------X-XXXXXXXXXXXXXXXXXXXXXXXX------
---------------XXt#kk-#########------XXXXXXXXXX-----------#------------S----###------------S---------------------------X------XXXXXXXXXXX-XXXXX-----XX
----------------XXXX--TT#X-####-------XXXXXXXXX-X-------T-------!-----------####-------------!#---S----------------------------------XX-------X------X
----K------------XX-XXXXX#XXX#--------------#-1--T-----tT-T-g----!----------###----o-!-------##-------------------------------------------------------
--------##-----------XXXXXXXXX-----C-------------XXXXXXXX----T-------------####X------#-----T###------------#-----------------------------------------
----!---!#-------------X---XX-------------------#-XXXXXXXXXXXX-g#-#--T---T######-----SS--S-K-###---t------###-----------------------------------------
--------###--------------------#---------------X------XXXX---XXXXXX##T-#---####---------T---T-#-----g---####------------------------------------------
-------T#X#------------------------------------##---------------XXXXXXXk#--#t##------##--y--##-#--------!#L-#!--------#-------------------------------
--------###-----S------------------------------S------------------y---XXXXXXXXX#---Xg-----K---###------T-t#-#S----------#--------S--------------------
-----S--###--------S------#---L----------------------------------------XXXXXXX#-----XXXXXXXXXXX--------T-T#-##----------!--------------------S#-#-S---
-------####-------!------#-----#-----------X--###------------------------------------XXXXXXXXXXX-----XXXX####----!-----##----------------------##-----
----k--TT##----------@----#---#-----#--------##-------------------------------------------------------XXXXXX##-##--U---#T#-------------!--o---###-!---
----T-#-##--------------yTK#-S##------------#-###------------------------------##------------------------XXX#X--------##-#----t-#------------####-----
-----!-#T#X--------##----###--##----------#T#####----------------------------#S-#-----------------------X---X-XXXgT----###-----TT-----------T-T##-----
XXXXX#XXXX--------#---!####-F##X----------#-#####----------S---------S--------###-------------------------------XXXt--XX#-------T-----T----tt-Tg------
XXXXXX-XXX-------!-#-##-#######------------#T####----------------S----L--o-----##--------------------------------XXXXXXXXXXXXXXXM---gT-g--T--#k##-----
