----------X-------------------------------X----X----------------X-------------oX---X-----X-----X-X-X---------------------------------X----------------
-------------------------S----------------------------------X---X--------------X---X-----------XS------S-----------------------X-----X----X-----S-----
--------------------------S-------------------g-XXg---------XS--------X------X-------------------------------S------X----X----SXS--S------X---S-------
S-------S--------S----S-------------o---------X-XXX--S----------------X-S----X---------------S----------o--X--------X----X-SX-----S-----S----------o--
S---------S-----------------------------S-S---XS--X-----------------------------------------------SS--X----XS---------------XS------------------------
S-------------------------------#--XS--------S-----------S----X-S------X-------S---S-----------S--X---X---------X--------------------S------------X---
S------------------S------------#--X-----------------------SS-X----X--rX-------------------S--------------------X--------------S------------------X---
S-------------------------------#----------------S-----------------X--X------X----------------#---------------------S----S----------------------------
S--------------r---------X------XX---X--------S---S--------------o----X------X------X---------#--o---X-----SX---------S-----S---------------X---------
S--------------X---------X--S---XX---X-------------------------------------X--------X-U-------X---S--XS-----X------------------------------SX---------
S--------------X-------------------------------------X--X-----S--S---------X--S------XSX------XX-S--------------S--!----------------------S-------S---
S----------------------------S-----------------------X#SX---S------S-------------S-----X-------X----------------o-------------------------------------
S-------------------------X---------------------------#----------------------S----------------------------X------------------------#-------------X----
S------------------------SX-----SS---S-----------S----#-------------------------#--------------------S----X-S-X----X-----------X-X-#--------S----X---X
XXXX-----X-TS--S-------X---S--------------------------X--------------o-----S----#----S--------S---------------X----X--------X--X-X-X-----------------X
XXXX--#S-X-X------X----X-------------------X----X----SX-!S----------------------#------S--XS---S--X-X-----------------------X------X------------------
