--------------------------------------------------------------------------------S#-SkS-SSSS--S-SXSS-------------------------------------SSS-S---S-S-SS
--------------------------------------------------------------------------------XXXXXXXXXXXXXXXXXXX---------------------------S---------SSS-S---S-S-S%
--------------------------------------------------------------------------------XXXXXXXXXXXXXXXXXXX-----------------------------------XXXXXXXXX-XXXXXX
------------------------------------------------------------------------SSSSSSSS----S--------------SSSSSSSSSSSSSSSSSSSSSSSSSSSSSSSSSSSXXXXXXXXX-XXXXXX
------------------------------------------------------------------------------SS----S--------------SSSSSSSSSSSSSSSSSSSSSSSSSSSSSSSSSSS----------------
-----------------------------------------------------------------------------SSS-------------------SSSSSSSSSSSSSSSSSSSSSSSSSSSSSSSSSSS----------------
-----------------------------------------------------------------------S------SSSSSSSSSSSSSSSSSSSSSSSSSSSSSSSSSSSSSSSSSSSSSSSSSSSSSSSS----------------
-------------------------------------------------------------------------------SSSSSSSSSSSSSSSSSSSSS-SS-------S---S--------SS--S--SS--SSSSSSSSSSSSSSSS
----------------------------------------------T--------------------------------SSSSSSSSSSSSSSSSSSSSS-SS-------S---S--------SS--S--SS--SSSSSSSSSS-SSSSS
----------------------------------------------S--------------------------------SSSSSSSSSSSSSSSSSSSSS-SS--o-g--S---S--------SS-oS--SS--SSSSSSSSSS-SSSSS
----------TT----------------------------------------------------o-----S-------SSS-S--S-S--S-SS-----SSSSSSSSSSU-SSS-SST-SSSSSSSSSSSSSSSSSSSSSSSSS-SSSSS
----------TT-------------#--S----##-#--#--------------------------------------SSS----S-S--S-SS-----SS--SS-SSSS-SSSFSST-SSSS-SSS-SBSSSS-SS-----SS--S-S-
----------TT-------------#------########--------------------------------------SSS---oS-S--S-SS-g---|S--SS-SSSS-SSSTSST#SSSS-SSS-S#S-SS-SS---o-SS--S-S-
--------k-TT----gg-------#--g--#########-----gy--ggg--kg----------------------SSbS-SSSSSSSSSSSSSSSSSS--SS--SSS-XSSTSST#S-SSgSSS-S#S-SS-SS-----SS--S-S-
XXXXXXXXXXXXXXXXXXXXXXXXXXXXXXXXXXXXXXXXXXXXXXXXXXXXXXXXXXXXXXXXXXXXXXXXXXXXXXXXXS-SSSS-SSSS--S-STSSXXXXXXXXXXXXXXXXXXXXXXXXXXXXXXXXXX-SSSSSSSSS-SSSSS
XXXXXXXXXXXXXXXXXXXXXXXXXXXXXXXXXXXXXXXXXXXXXXXXXXXXXXXXXXXXXXXXXXXXXXXXXXXXXXXXXS#SS-S-SSSS--S-STSSXXXXXXXXXXXXXXXXXXXXXXXXXXXXXXXXXX---SSS-S---S-S-S
