-X---XXX----------X-X-#---#-----#-X-----XX-#M---X#---#----X-----#---#-X--#-------------------#X---------#--X---X--#-#-2-#X--X----XX---X----------#XX-t
--------XX#XX--#--#---#---X#--#------S-#-X---XX-S-------X---#-X-----#-#-#--#--X--------------#X----#-X--#---!-XX-------XtX--X#-----#X#----------------
-------X------X-----#---X-#X--X-----t-----X-#---------X----X#-XX--X-----X-#---#----XX----#X-S--------#g-X----X------S!-XXXX-----X#-----##-#-X-Xt------
-X-----#X-#--------#--#----X--X-#-#---#!---#-t--#---#-X----X---XX-----S----#------X---#-XXX--XX--#------#--#--X-----X--#----X-------##--#-#X-#-X------
-------X-X----X---g--X--X-#--#--------X---------------X-#-tX-----XX-----------#-XX----X---#---#-X-----------#tX--X--#---XX#------#------X---XX-X--#---
--X----X--#---------!--------X---X-----#---X--X----X-#-C#--------X!-t-#-----t-#-#-g-X-X-X---X-#-#----X#XX--X-#--------X------------X----XgX-X-#--#X#--
-X-X#--X#----------X-----X---X---#---X-------X---X@--X---!-S##X--#-#-XX-XtX#--X-------k#---Xgg-------X----#-----X#-#--X-#-X---X--S#----#-X#----#------
----!------#---X-X---C------X-X-----#-#--------#-S-t--U#-----X#X--XX-#-----##--g#------#-X#XX----X--XXS----X-------#--#-#----XX----X----X-X----XXX----
----t###--#--X---#----------X--X-X-g--------X--------#----------------#---#XXX--!--X-#------S-XX#-#--S##-X---X--X#-X---X#-----#-t--#--X-X-XX--XX-#-X--
--XXX-X-X#X-g-#X--X---#tX-X--X---#----#-X----X#--X----------------XX-----------t-#-X-------#X-#!-----|XS-X-------t-----#-------X---X--------X---------
--t------X-XX-#--#-----#SX---X---X-t-X-C--S-g--#---#----X#--X---#X-X-#---#---X#---X-X--#------#-X---#-X----t-#X-------#-----X-XXXg#X#----XX#---------#
--X-XX--------S-----X#-----#X---S--X----S--X---#---X---------X----X---X#X---#-X#-#--X-X---!--X--X##--#-XX-X-g--XX#-----##-XX-XX-X------------X--X-X---
-!#---#----------#---#-X-#---#----------!---X--------C-----#--kS-------------X--XX----X---X---X----X-X-#X--X--X---t----#-----------X----X-X--X------#-
-----X---#-#----S-Xt-----------X#--XXS-----#--X!X------X--XX--t-X--X------#XS--XX------------X-XX---t#--#--XX-------S---gX----#-------#---t-#k#----t--
X-----------#-XX-X#SX-#----------X-----X-------------------X-X-------X--X---X#X--------##---------#---X--##-------X---XX-#--g-#---XX-------#---X----!-
X----#-----t-------#-#--XXX-----X-Xt-#-----X-X---##---X--X----------#XX-----XX---#-X---#--#--X#X----------XX---#-X-XXX-X-#--X----X---t--------#XX-X--X
