------X------K-X--R-X-S---YX-----*-----%--------------L---!--G----X-#XXXX-------XX------X---1----L----X------X--------X----#X-------------------------
---------X----X-----r--XX-----------------------G------X------X-----------X-XX-D-----X-----X---X-------------G---------S--X-o---------C---XX---X-----X
--------------X------------y---------XD---X-------X--X---XX--XK-------X-----------X--X--g-----------------X---C------F---------L---------X---------L--
------X--gXXX----X-----------X--------T--X---------X-1-----g---------@---X---X-X-------------------XXD--X--@--------------------#---------------------
------------X---X-----X--X-2--X--#--------X-----X-X-------#-X---XX---------SX-------#X@----T---#--#X---X---C-*---X---1--D%--XXX----------------T--X---
-------X----------r---X--XX-X-o---X--------X--X---X---X----------XXF-----------------XX--r--X------X---X---------X-X-X------------XX--gX---X--XX-----X
------X-XM-TY-X-X---X-----rX---X-------X----X@------------X---X--tYX---X---X%----XF-----1-X------X--X-----------------1X----------------------X-------
-------t@XX--X-----------------XXt--!XX--X-------------X------X--------X-#-|X--------------------------X-X-X---*XXk-----X-X--M-----XX----X-X--------#-
----X---------------------X-----XX-------X-----X--X--X------------X----------#-------L--*---@X*-----gF---|---o---------------------X--XX-----SX--X---1
----X-------------------------@------------------------X--X------------X--*------g----X----X--@L----------X-X---X--X-X-------L--X-X---------X--X------
------------#----------X-----F-----------X--r----X---TX-X----------X--------X-#--T--------------------K---XX------MS-----X------oX---XFXX--@X------X--
-----------------X-X--L------------X----X-M--X------Y-#X--X#-X---F------X-X-X-----S-----g--X----X-------T------XXt------#--------X--X----#-------*----
-----X-----X-------D--------XX----X--X---------------X-----X--------------C----------X--R------------g--------------X------X----X----C--------S--X----
-------%--X------X%X---o-----------------------X-----------FRXXX-X---XX-----X---X--M-------X-t----X---X-X-------------g-----X---C------Y--------------
XXXX--XX---U------|------Xg------------%----X--X-------X--------X-------X------XXX----X-----X--g-X--R-------------------X-X------1-------S--X---X--X-g
XXXX--r--------*----T-|-------------X------X-----#-X-X------F----X---t-----g@X-----T---X----#X--------X---kX--X--o--------C-------C----X----K#--------
