-------------------------------------------------------------------------------------------------------------------------------------------------------------------------------------------------------------------------------------------------------------------------------------------------------------------------------------------------------------------------------------------------------------------------------------------------------------------------
-------------------------------------------------------------------------------------------------------------------------------------------------------------------------------------------------------------------------------------------------------------------------------------------------------------------------------------------------------------------------------------------------------------------------------------------------------------------------
-------------------------------------------------------------------------------------------------------------------------------------------------------------------------------------------------------------------------------------------------------------------------------------------------------------------------------------------------------------------------------------------------------------------------------------------------------------------------
-----------------------------------------------------------------------------------------------------------------------------------------------------------------------------------------------------U-------------------------------------------------------------------------------------------------------------------------------------------------------------------------------------------------------------------------------------------------------------------
-------------------------------------------------------------------------------------------------------------------------------------------------------------------------------------------------------------------------------------------------------------------------------------------------------------------------------------------------------------------------------------------------------------------------------------------------------------------------
----------------------------------------------------------------------------------------------------------------------------------------------------------------------------------------------------------------------------------------------------------------------------------------------------------------------------SSSSCSSS--------------------------------------------------------------------------------------------------------------------------##---------
---------------------LSSS---------------------!!!!!-----------USSS------------------------------------------------------------------------------------------------------------------SSSSS----------------------#---------------------------------------------------------------------------------------------------------------------------------------------------------------------------------------------------------------------------------------------###---------
-------------------------------------------------------------------------------------S1SSSSSSSSSSSSSSSSSSSSSSSSSSSSSSSS--------------------------------------------------------------------------------SS------#---------------------------------------------------------------------------------------@----------------------------------------------------------------------------------------------------------------------------------------------------####---------
-----------------g------------------------------------------------------------------------------------------------------------------------------------------------------------------------------------------#--##-------------------------------------------@---------------------------------------------------------------------------------------------SSUSSSSS-------------------------------oo---------------------tt---------------------------------#####---------
-----------------#------------------------------k-----------------------------------------------------------------------------------------------------------------B------------------K-------------SS------##--##--------------oooooo-----------------------------------------------oooo-----------------------------------#----2----#------------------------------------------------------------------------------TT--tt--------------------------------######---------
--------SUS-----##---2-----#-----------TT-----@!!!!----------S-----TT---!!!!------------------------------------------------------------------S@---------SS------S#2----------------SSSSS-----------------###--##---##---------------------------------------------------ooo---------------------------C-------------------#------K--#-------K------------------------------------------------------------------TT--TT--tt-------------------------------#######---------
---------------###---------#-----------TT--------------------------TT---------------------------K---------K--K----------SS--------------B-------------------------------B--------------K---#----B--------####--##---###---------------------------K------------------------------------------------TT--------#-------------#---------#-----------K----------------------------------#---------------------------TT--TT--tt------------------------------########--------F
--------------####---------##----------TT--------------------------TT-----------------#-----------------------------------------B-----K-bK----------B-------------------b-----TT-----------#----b-------#####---#---####------------------------------------#--------------------------------------TT---#----##-------ggg--#---------#--------------------------------------------kk#----------------------ggg--TT--TT--tt-----k--ggg-----ggg------ggg-#########--------#
--M----------#####----kk---##---gg-----TT------------gg----k-ggg---TT-----------------#-----------------------------------------b-------B-----------b--y------B--y-y----b-----TT-----------#----B------######-------#####-----TT-----##----gg-----------#---#-------k-kkk----kk----------kkk-------TTk--#----XXX--XXXXXXXXXXXXXXXXXXXXXXXX-X-XX-X-XX-XXXXXXXXXXXXXXXXX-X-X-XXXXXXXXXXXXXXXXXXX------XXXXXXXXXX-XX--XX--XXXXXXXXXXXXXXXXXXXXXXXXXXXXXXXXXXXXXXXXXXXXXXXXXX
XXXXXXXXXXXXXXXXXXXXXXXXXXXXXXXXXXXXXXXXXXXXXXXXXXXXXXXXXXXXXXXXXXXXXXXXXXXXXX-XXXXXXXX-XXXX-X-XXX-XXXXXX-XXXXXXXXXXXXXXX--XXXX-XXXXXXXXXXXXXXXXXXXXXXXXXXXXXXXXXXXXXXXXXXXXXXXXXXXXXXXXXXXXXXXXXXXXXX-XXXXXXXXX----XXXXXX----TT------XXXXXXXXXXXXXXXXXXX---X--XXXXXXXXXXXXXXXXXXXXXXXXXXXXXXXXXXXXXXXXXX----XXX--XXXXXXXXXXXXXXXXXXXXXXXX-X-XX-X-XX-XXXXXXXXXXXXXXXXX-X-X-XXXXXXXXXXXXXXXXXXX------XXXXXXXXXX-XX--XX--XXXXXXXXXXXXXXXXXXXXXXXXXXXXXXXXXXXXXXXXXXXXXXXXXX
XXXXXXXXXXXXXXXXXXXXXXXXXXXXXXXXXXXXXXXXXXXXXXXXXXXXXXXXXXXXXXXXXXXXXXXXXXXXXX-XXXXXXXX-XXXX-X-XXX-XXXXXX-XXXXXXXXXXXXXXX--XXXX-XXXXXXXXXXXXXXXXXXXXXXXXXXXXXXXXXXXXXXXXXXXXXXXXXXXXXXXXXXXXXXXXXXXXXX-XXXXXXXXX----XXXXXX----TT------XXXXXXXXXXXXXXXXXXX---X--XXXXXXXXXXXXXXXXXXXXXXXXXXXXXXXXXXXXXXXXXX----------------------------------------------------------------------------------------------------------------------------------------------------------------
