----------------------------------------------------------------------------------------------------------------------------------------------------------------------------------------------------------------------------------------------------------------------------------------------------------------------------------------------------------------------------------------------------------------
----------------------------------------------------------------------------------------------------------------------------------------------------------------------------------------------------------------------------------------------------------------------------------------------------------------------------------------------------------------------------------------------------------------
----------------------------------------------------------------------------------------------------------------------------------------------------------------------------------------------------------------------------------------------------------------------------------------------------------------------------------------------------------------------------------------------------------------
----------------------------------------------------------------------------------------------------------------------------------------------------------------------------------------------------------------------------------------------------------------------------------------------------------------------------------------------------------------------------------------------------------------
----------------------------------------------------------------------------------------------------------------------------------------------------------------------------------------------------------------------------------------------------------------------------------------------------------------------------------------------------------------------------------------------------------------
-------------------------------------------------------------------------------oo--------------------------------------------------------------------------------------------------------------------------------------------------------------------------------------------------------------k----------------------------------------------------------------------------------------------------------------
------------------------------------------------------------------------------SSS----------------U----------------------------------SUS--------------------USSS----------------------------------------------------k---SUS-----------------------------------------r-------------------------SUS-------------------------------------------------r------------------------------------!-1-----------------------
--------------------------------------------------------------------------------------------------------------------------------------------------------------------------------------------------------------------------------------------------------------------------------------------------------------------------------------------r--------------------------------------------------------oooo-------
-----------------k---------##k-----------##------------------------------k---------------------------------------------------------------------------------------------------------------------------------------------------------------------------------------------------------------------------------------------g--------------------k-------------------------------------------------------------------
-----------------#--------###-----------###--------------------------------------SSS--------------------------------------------------------------------------r----------------------------------------------------------k-----------------------------------------------------------------------------------------------------------oooooo---------------------------------------------------------------------
--------SUS-----##---2---####--S------#####--S------##--#--------------@@@@-D------------------------------------------------------#####----------------TT--------TT----------------------------------------------k---#####-----------------------------------------------------------------#####-----------------------------------------------------------------------------------!-!!!!----------------------
--------------k###------#####--------######--------###--##-------------------------------------------------------------------------#--------------------TT--tt----TT--------------------------------------------------#-------------------------#--------k----------------------------------#-------------------------######--------------------k-------KK-----------------------------------------#------------
--------------####-----######-------#######------k####--###-----kk-----------------k----------------------------------------------K#--------------------TT--tt----TT--------------------------------------------------#--------------------k----#-------------------------------------------#--------------------B----########k------------------------------------#-------------------------------#------------
--M----------#####----k######------k#k#####------k####---###---ktt----X---r-----koo------#------kggg----krkg#------k-gg--k--------k#---------k-k--gg----kT--tt--T#TT---k-----k---rr-rT-rrkr--kggr------ggg-------r-k-r#-----------k--gg----b----##---ggg--k--k-----ggg-------grg---------k--#k------------ggg----kk---#-#######-----TT-----##----gg-----------k----##--------y---------yy----------#--------ry--
XXXXXXXXXXXXXXXXXXXXXXXXXXXXX--XXXXXXXXXXXXr-XXXXXXXXX--XXXXXXXXXXXXXXXXXXXXXXXXXXXX----XXXXXXXXXXXXXXXXXXXXXXXXXXXXXXXXXXXXXXXXXXXXXX----XXXXXXXXXXXXXXXXXXXXXXXXXXXXXXX---XXXXXXXXrXXXXXXXXXXXXXXXXXXXXXXXXXXXXXXXXXXXX----XXXXXXXXXXXXXXXXX--XXXXXXXXXXXXXXXXXXXXXXXXXXXXXXXXXXXXXXXXXXXXXXX----XXXXXXXXXXXXXXXXX--XXXXXXXXXX----TT------XXXXXXXXXXXXXXXXXXX----XXX--XXXXXXXXXXXXXXXXXXXXXXXXXXXXXXXXXXXXXXXX
XXXXXXXXXXXXXXXXXXXXXXXXXXXXX--XXXXXXXXXXXX--XXXXXXXXX--XXXXXXkXXXXXXXXXXXXXXXXXXXXX----XXXXXXXXXXXXXXXXXXXXXXXXXXXXXXXXXXXXXXXXXXXXXX----XXXXXXXXXXXXXXXXXXXXXXXXXXXXXXX---XXXXXXXXXXXXXXXXXXXXXXXXXXXXXXXXXXXXXXXXXXXXX----XXXXXXXXXXXXXXXXX--XXXXXXXXXXXXXXXXXXXXXXXXXXXXXXXXXXXXXXXXXXXXXXX----XXXXXXXXXXXXXXXXX--XXXXXXXXXX----TT------XXXXXXXXXXXXXXXXXXX----XXX--XXXXXXXXXXXXXXXXXXXXXXXXXXXXXXXXXXXXXXXX
