-------------------------------------------------------------------------------------------
-------------------------------------------------------------------------------------------
-------------------------------------------------------------------------------------------
-------------------------------------------------------------------------------------------
-------------------------------------------------------------------------------------------
-------------------------------------------------------------------------------------------
---------------------LSSS-------------------------------------------------------##---------
-------------------------------------------------TT----------------------------###---------
-----------------g-------------------------------TT---------------------------####---------
-----------------#--------------------------T----TT--------------------------#####---------
--------SUS-----##---2-----#---------------STT--CCC@------------------------######---------
---------------###---------#------TT--------TT-----------------------------#######---------
--------------####---------##-----TT--------TT-------------------TT-------########--------F
--M----------#####----kk---##---g-TT------g-TT-----r----------r--TT----g-#########--------#
XXXXXXXXXXXXXXXXXXXXXXXXXXXXXXXXXXXXXXXXXXXXXXXXXXXXX---XXXXXXXXXXXXXXXXXXXXXXXXXXXXXXXXXXX
XXXXXXXXXXXXXXXXXXXXXXXXXXXXXXXXXXXXXXXXXXXXXXXXXXXXX---XXXXXXXXXXXXXXXXXXXXXXXXXXXXXXXXXXX
