------------------------------------------------------------------------------------------------------------------------------------------------------------------------------------------------------------------------------------------------------
------------------------------------------------------------------------------------------------------------------------------------------------------------------------------------------------------------------------------------------------------
------------------------------------------------------------------------------------------------------------------------------------------------------------------------------------------------------------------------------------------------------
------------------------------------------------------------------------------------------------------------------------------------------------------------------------------------------------------------------------------------------------------
------------------------------------------------------------------------------------------------------------------------------------------------------------------------------------------------------------------------------------------------------
--------------------------------------------------------------g----------------------------------------------------k----------------------------------------------------------------------------------------------------------------------------------
------------------SCS-----------------------------------------SSSSS-----SSSSS---------------------------------S---SSSSSSSSS------------US---SS-------------SSS-----------------------------------------------------------------------------##---------
---------------------------TT-----------------------------------------------------------------------------TT------------------------------------------------------TT----------------------------------------------------------------------###---------
---------------------------TT----------------------------TT-----------------------TT----------------------TT------------------------------------------------------TT---------------------------------------------------------------------####---------
---------------------------XX----------------------TT----TT-----------------------TT----------------------TT-------------------------SS---------------------------TT--------------------------------------------------------------------#####---------
-----SSS------TT---2---TT----------------TT---SU---TT----XX------------------2----TT-------------tt------SXXS------------------------------SSS---------#---SSS----XX-----TT---------TT----------------##--#------------SS!S------------######---------
--------------TT-------TT-------------K--TT--------TT----------------------TT-----TT-----TT------tt-----------------------------------------------#-TT-#-----------------TT-----TTTTTT----TT---------###--##--------------------------#######---------
--------------TT-------TT-----TTTT-------TT--------TT---------TT-----tt----TT--TT-TT-----TT------tt-TT--------TT--------------TT--TT-------------##-TT-##----------------TT---TTTTTTTT----TT--------####--###-----tt--------------tt-########--------F
--M-----------TT----k--TT-----TTTT-------TT------k-TT---------TT-----tt----TT--TT-TT---k-TT------tt-TT--------TT--------------TT--TT------------###-TT-##---------k------TT---TTTTTTTT----TT-------#####--####----tt---------gg---tt#########--------#
XXXXXXXXXXXXXXXXXXXXXXXXXXXXXXXXXXXXXXXXXXXXXXXXXXXXXXXXXXXXXXXXXXXXXXXXXXXXXXXXXXXXXXXXXXXXXXXXXXXXXXXXXXXXXXXXXXXXXX------XXXXXXXXXXXX-X-XXXXXXXX-XXXXXXXXXXXXXXXXXXXXXXXXXXXXXXXXXXXXXXXXXXXXXXXXXXXX--XXXXXXXXXXXXXXXXXXXXXXXXXXXXXXXXXXXXXXXXXXXX
XXXXXXXXXXXXXXXXXXXXXXXXXXXXXXXXXXXXXXXXXXXXXXXXXXXXXXXXXXXXXXXXXXXXXXXXXXXXXXXXXXXXXXXXXXXXXXXXXXXXXXXXXXXXXXXXXXXXXX------XXXXXXXXXXXX-X-XXXXXXXX-XXXXXXXXXXXXXXXXXXXXXXXXXXXXXXXXXXXXXXXXXXXXXXXXXXXX--XXXXXXXXXXXXXXXXXXXXXXXXXXXXXXXXXXXXXXXXXXXX
