--------XXX-XXXXXXXXXX-----------------------X--XXXXXXXXXXX-----XXXXXXXXXXXXX--XXXXXr-XXXXXXXXXXX--------------r--XXXXXXXX--------------XXXXXX------------r-----------------------r----r-----------------------r-------------------------r--------------------------------r----------------------------------------------------------r---r----------r--XXXXXXXXXXXXXXX--------------r---------------------------
-----------r-------------------r--------------r-------------r-------------------------XXXXXXXXXXX---------r--XXX-----------r------------XX----r------------------r------------------------------------r---------------------------------------------------------------------------------------------------------------------------r--------------------XXXXXXX-----XXX-----r------------------------------------
-----------------------------------------------------------------------------------------------------XXXXXXXXXXX------------------r---------------r-r-----------------------------------------------------------r-----------------------------------------------------------------------------------------------------------------------------------------------------------r---------r-----------r-------------
--------r------------r----------------------------------------------------------------------------r--XXXXXXXX-----r---------------------------------------------------------------------------------------------r-------r-------------r----------------r-r---r-r------r-r------r----------r---r---r----------r----------------r-------------------------------r--------------r-------------r--------------------
---------------------------------------------------------------------------------------------------------------------------------------------------r---------------r--------r---------2-----2------------K-----r-r--------------------2-------------2--rSSSS-------------r----r---------------S---rSSSS------r-----------------------------------------r-----------r----------r---------r---r-------------------
------------------------------------------r-r-r------------------------------r-----------------------------r-r------------r------------r--r--------S---------------------------------------------------------------------------------------------------------------------rr-------------r------------------------------------------------------------r----------------r------r----------------------------------
----------------------r------------------rSS-------------r-------r----------------------------------------------r----------------------r----------r---------r----------------------------------------------r---------------------------------------------------r--------------------------------------------------------------------r-----------r-----------------r----------------------r--------#-------!-----
-----------r-----------------------------S----S-------rS-SSSSr----------------------2r------------------r-------r-----------------r-----------2-------r--------------------------------2-----2-------------#----------------------------------------------r-------r-----------r-------------r--------------------r-------------------r-----------S----------------r-----------------S------------##-------------
---------------------------r--------------------------r---------------------r------------------r-r-------r------r--------------------------r-------------------------------------------------------------#-#---------------------------!-------------------22---------t----------------TT-------------------------------------------------------------------------r--------------oo-----------#--##-------------
---------------------------------------------------------------C-r----------------------r-------Sr------------------r------------------------------r-----------------------r----------------------------##-#----------------------------------------------------r-----t----------------TT------------------------------------------------------------r----------------------------------------#--##-------r-g-r-
-----S@---------------------------------------------------------g--------------------------------S---------------------------------------------------------------------#---r---------------------------###-XX--XX-----------------r-------------r----r----------------t-r--B--------r--TTr----T-r--------tt-----B---r---------r-------------------------------------------------------o------##--##---r--grgX---
----------!-----------------------------------SS--------------------------------------------------------------------------K-------r--------------B---------------------#----------r--r--r--r---g-------XXX-XX--XX--r---rr--rr-----r--r--r-ggg--rr--r----------rgr-grg-t----b---r-------TT-----Trr-X------tt-r---br-**--ggg---r---------TT-----r----------tt-------------------------r--------##--##XXXXXXXXXX---
-------------------------r---------------T---K-------------------T--------------#------#---------------------------------------r--g-------#------b-X--------------B----#---------rrXXXXXXXXXXXXXXXXXXXXXXX---r------XXXXXXXXXXXXXXXXXXXXXXXXXXXXXXXXXXXXXXXXXXXXXXXXXXXXXX-XXXXXXXXXXXXXXX-XXXXXX-X------XXXXXXXXXXXXXXXXXXXXXXXX-X----TT----r-----------tt-------K----------Xr-------------##X--XXXXXXXXXXX----
--M---r--------------r------r--r--ggg----Tk----------------------Tt-------------#--------------------------------------K----XXXXXXX--ggg-##----XXXXXX-r----gg-rr--b-X--XXXXXX--XXXXXXXXXXXXXXXXXXXXXXXX-------------XXXXXXXXXXXXXXXXXXXXXXXXXXXXXXXXXXXXXXXXXXXXXXXXXXXXXX-XXXXXXXXXXXXXXX-XXXXXX--------XXXXXXXXXXXXXXXXXXXXXXXX-XX-rTTT-r-r-r---rrr----tt---------------r-XX------Xr--r--##XX--XX-------------
XXXXXXXX---r-------rr--XXXXXXXXXXXXXXXXXXXXXX---------kk---------Tkrr------r----#--r---------r----------------------r------XXXXXXXXXXXXX-##--r-XXXX-XXXXXXXXXXXXXXXXX--XXXXXX--XXXX----------------------------r-------------------------------------------------------r-----------------------------------------------------------XXXTXXXXXXXXXXXXXX----tt------------X---XX-------X--XXXXXXX------------------
XXXXXXXX-XXX-XXXXXXXXXXXXXXXXXXXXXXXXXXXXXXXX-X--XXXXXXXXXXX-----XXXXXXXXXXXXX--XXXXX----rrrr---gg-----------------XXXXXXXXX-------XXXXXr##XXXX------XXXXXXXXXXXXXXX--------------------------------------r----r-------------------------------------------------------------------------------------------------------r------------XXXXXXXXXXXXXXXXXX-r-tt--rrXXXXX--XX---X-----------XXXXXX-------------------
