------------------------------------------------------------------------------------------------------------------------------------------------------------------------------------------------------
------------------------------------------------------------------------------------------------------------------------------------------------------------------------------------------------------
------------------------------------------------------------------------------------------------------------------------------------------------------------------------------------------------------
------------------------------------------------------------------------------------------------------------------------------------------------------------------------------------------------------
------------------------------------------------------------------------------------------------------------------------------------------------------------------------------------------------------
------------------------------------------------------------------------------------------------------------------------------------------------------------------------------------------------------
-----------------------------US-------------------------------------------------SSSSSSS---SSS!--------------@-----------SSS----S!!S--------------------------------------------------------##---------
------------------------------------------------------------------------------------------------------------------------------------------------------------------------------------------###---------
---------------------------------------------------------------------oo--------g---------------------------------------------------------------------------------------------------------####---------
-----------------------------------------------------------------y----------------------------------------------------------------------------------------------------------------------#####---------
---------!!-----------------####--SSC------------------ooo-------##----------S@S-------------C-----SU----!--!--!-----S----------SS------#--#----------##--#------------SS!S------------######---------
-----------------------y-#####----------------------------------###--------------------------------------------------------------------##--##--------###--##--------------------------#######---------
--------------------y-######-----------------------------------####-------------------------------------------------------------------###--###------####--###-----tt--------------tt-########--------F
--M----------------#######------------------y-y---------------#####---------------------------g-g--------k-----------------gg-g-g----####--####----#####--####----tt---------gg---tt#########--------#
XXXXXXXXXXXXX--XXXXXXXXX------XX--XXXXXXXXXXXXXXXX--XXXXXXXXXXXXXXX---XXXXXXXXXXXXXXX---XXXXXXXXXXXXXXXXXXXXXXXXXXXXXXXXXXXXXXXXXXXXXXXXXXXXXXXXXXXXXXXX--XXXXXXXXXXXXXXXXXXXXXXXXXXXXXXXXXXXXXXXXXXXX
XXXXXXXXXXXXX--XXXXXXXXX------XX--XXXXXXXXXXXXXXXX--XXXXXXXXXXXXXXX---XXXXXXXXXXXXXXX---XXXXXXXXXXXXXXXXXXXXXXXXXXXXXXXXXXXXXXXXXXXXXXXXXXXXXXXXXXXXXXXX--XXXXXXXXXXXXXXXXXXXXXXXXXXXXXXXXXXXXXXXXXXXX
