--------------------------------------------------------------------------------------------------------------
--------------------------------------------------------------------------------------------------------------
--------------------------------------------------------------------------------------------------------------
--------------------------------------------------------------------------------------------------------------
--------------------------------------------------------------------------------------------------------------
---------------------------------------------------------------------------------------------------y----------
---------------------LSSS--------g-----------------------------------------------------------------##---------
-------------------------------------------------------------------------------------------------y###---------
-----------------g-------------------------@---------g-------------------------------------------####---------
-----------------#-------------------------------------------------oooo----------------------gg-#####---------
--------SUS-----##---2-----#----------------------------ooo------------oo----S-------------!---######---C-----
---------------###---------#------------------------------------------------------------------#######---------
--------------####---------##--------------#-------------------------------------------------########--------F
--M----------#####----kk-k-g#---gg-----#---#-------k-kkk----kk-------------k-----y-----kg-g-g########--------#
XXXXXXXXXXXXXXXXXXXXXXXXXXXXXXXXXXXXXXXX---X--XXXXXXXXXXXXXXXXXXXXXXXXXXXXXXXXXXXXXXXXXXXXXXXXXXXXXXXXXXXXXXXX
XXXXXXXXXXXXXXXXXXXXXXXXXXXXXXXXXXXXXXXX---X--XXXXXXXXXXXXXXXXXXXXXXXXXXXXXXXXXXXXXXXXXXXXXXXXXXXXXXXXXXXXXXXX
