--------------------------------------------------------------------------------------------------------------------------
--------------------------------------------------------------------------------------------------------------------------
--------------------------------------------------------------------------------------------------------------------------
--------------------------------------------------------------------------------------------------------------------------
--------------------------------------------------------------------------------------------------------------------------
----------------------------------------------------------------------------------------------------------------k---------
-----------------------------US---------------------------------------SS!SSS@SSS--------SSC--------------------##---------
--------------------------------------------------------------------------------------------------------------###---------
------------------------------------------------------------------------------------------------#-----------k####---------
--------------------------------------------------------------k---------K---------------SSS-----#-----------#####---------
---------!!-----------------####--SSC------------------ooo----TT------SSSSSSSSSSS---------------#----------######---------
-----------------------y-#####--------------------------------TT-------------------------------##---------#######---------
--------------------y-######----------------------------------TT-------------------------------##--------########--------F
--M----------------#######------------------y-y---------------TT--------------K----------------##-------#########--------#
XXXXXXXXXXXXX--XXXXXXXXX------XX--XXXXXXXXXXXXXXXX--XXXXXXXXXXXXXXXXXXXXXXXXXXXXXXXXXXX----XXXXXX---XXXXXXXXXXXXXXXXXXXXXX
XXXXXXXXXXXXX--XXXXXXXXX------XX--XXXXXXXXXXXXXXXX--XXXXXXXXXXXXXXXXXXXXXXXXXXXXXXXXXXX----XXXXXX---XXXXXXXXXXXXXXXXXXXXXX
