-------------------X--------------------------------S---------------------------------------------------------------------------------------t---------
-----------------------------------------------------T-----------------------------------------------S------#-------------------------------t-----%#--
-----------------------------------------------------T-@---------------@------------------------------------XXXX---------------------------TXXXXXXXXXX
-----------------------------------------------------T-K-------------------S----------------S---------------#XXX---------------#-------#---XXXXXXXXXXX
----S-----------S--------S-g-------------------------T-----------S------------------------------T-------#----------------------#--#----#-F-X----------
-----------------S--------SS-------!------------T----Tk-----------------------------------------T-S--T--#-------------------##-#--#----###------------
---------------S---------------------------F----T----TXX-----------------------S--T-------------TT---T--#--#-------------!--####-B#----###X-----------
-------------------------S---T-------T-T---#----TXXXXXXX----------------T---T-----T--1----------TT---T--#--#----------------####-b#----#XXX-----------
-------------------------2---T-------T-T---#XXXXXXXXXX-----S---S--------T---T-----T--|XXXXX----TTT---T--#--#---------------#####XXXXXXXXXX------------
--------------------------T--T---XXXXXXXXXXXXXXXX---S-----------------S-T---T--K--T--XXXXXX----TTTXXXXXXXXXX---------------##XXXXXXXXXXX--------------
---------S----SST---------T--T---XXXXXXXXXXX------------X-----t---------T---T--tXXXXX------X---TXXXXXXXXXXXX---------S-S--|#XXXX----------------------
------S---------T-----U---XXXXXXX-----------------------X-----t---T-----TXXXXXXXXXXXX------XXXXXXX----------------------F-#XX-------------------------
----------------T#--------XXXXXXX--------------------------XXXXXXXX-----XXXXXXXX------------XXXX------------------------tXXX--------------------------
----------------T#----------------------------------------gXXXXXXXXXXXXXX-----------------------------------------------#XX---------------------------
XXXXXXXXXXXXXXXXXXXX-------------------------------------XX--------XXXXX--------------------------------------S---XXXXXXX---------------------S---S---
XXXXXXXXXXXXXXXXXXXXX------------------------------------XX-------------------------------------------------------XXXXXXX-----------------------------
