-----------------------------------S---------S------!#----------#---#----------#-#----##t-#-##---XXXXXXXXXXXXXXXXXXXXXXXXXXX--------------------------
-----------------------------------------------------#----------#--------------#-#----##t-#-##---XXXXXXXXXXXXXXXXXXXXXXXXXXX--------------------------
-----------------------------------------------------#----------#----XXXXXXXXXXXXX--XXXXXXXXXX---------------------------------------------S---------S
-----------------------------------------------------#-----#--2-#----XXXXXXXXXXXXX--XXXXXXXXXX------------------------------B--------------------##---
------------------------------------------@-#-------##-----#XX-T#--------------------------------------------------------------------------------##---
----------------------------------B--------T#-#------#-----#XX-X#---------------------------------o--------------------------------------------#-##k--
----------------------------------b--------T#-#------#-----#X---#-U------------------------------------------------------------------#-----!#-##-XXXXX
----------------------------------b--k-k---T#-#K-g-yg#-----#X---#--------------------------------------------------------------------#------####-XXXXX
---------------------------------XXXXXXXXXXXXXXXXXXXXXXXXXXXX---X--------------------------------------------------------------------##-----####------
---------------------------------XXXXXXXXXXXXXXXXXXXXXXXXXXXX---X------------------------------S-------------------------------------##g-#--####------
-----------------------T-!--t------------------------------------#-#---S-------S--------#--#-y#------------------------------------!-##S-XXXXXXX------
------K----------------T----t------------------------------------#-#-------o--------o---#--#-##----------------------o---------------##K-XXXXXXX------
-----------------------T----t-T----------------------------------#-#--------------------#--#-##---------------@---!------#----------###-y-------------
----------k------g-----T#---tgT----------------------------------#g#------------g-------#--#-##-----T-------------------T#----------###KX----------K--
XXXXXXXXXXXXXXXXXXXXXXXXXXXXXXXXX--------------------------------#XX---!@-------#-#-----#--#-##-----T-----#-------------T#----XXXXXXXXXXX-------------
XXXXXXXXXXXXXXXXXXXXXXXXXXXXXXXXX--------------------------------#XX------------#-#----##--#-##-----T-g-#-#-------------T#--g-XXXXXXXXXXX-S---S-------
