----------------------------------------
----------------------------------------
----------------------------------------
----------------------------------------
----------------------------------------
-----------------------------k----------
-----------------------------##---------
-----------------------------##---------
-----------------g-------k-####---------
-----------------#--------#####---------
--------SUS-----##-------######---------
---------------###------#######k--------
--------------####----k########--------F
--M----------#####---kt########-----T--#
XXXXXXXXXXXXXXXXXXXXXXXXXXXXXXXXXXXXXXXX
XXXXXXXXXXXXXXXXXXXXXXXXXXXXXXXXXXXXXXXX
