---------------------------------------------------------------------------------------------------------------------------------------------------
---------------------------------------------------------------------------------------------------------------------------------------------------
---------------------------------------------------------------------------------------------------------------------------------------------------
---------------------------------------------------------------------------------------------------------------------------------------------------
---------------------------------------------------------------------------------------------------------------------------------------------------
---------------------------g-----------------------------g-----------------------------------------------------------------------------------------
-----------------------------US---------------------------g--1--------------------------------------------------------------------------##---------
--------------------------------------------------------------------------oooo----------oooo------------oooo----------------------------##---------
---------------g------------------------------------------------------------------------------------------------------------------------##---------
-------------------------------g-------------------------------------------------------------------------------------------------K--g#--##---------
-----S--S!!--------------g--####--SSC------------------o---o!!!-----------------------T--------------TT------------!----------------##--##---------
-----------------------y-#####------------------------------------------#------------TT--------------TT----------------------------###--##---------
--------------------y-######--------------------------------------------#------------TT--------------TT--------------g------------####------------F
--M----------------######g------------------y-y--g-------k--yy--------gy#---------y--TT---yy-----y---TT---g-------k-gg---g-------#####--k---------#
XXXXXXXXXXXXX--XXXXXXXXX------XX--XXXXXXXXXXXXXXXX--XXXXXXXXXXXXXXXXXXXXXXXXXXXXXXXXXXXXXXXXXXXXXXXXXXXXXXXXXXXXXXXXXXXXXXXXXXXXXXXXXXXXXXXXXXXXXXX
XXXXXXXXXXXXX--XXXXXXXXX------XX--XXXXXXXXXXXXXXXX--XXXXXXXXXXXXXXXXXXXXXXXXXXXXXXXXXXXXXXXXXXXXXXXXXXXXXXXXXXXXXXXXXXXXXXXXXXXXXXXXXXXXXXXXXXXXXXX
