---------------------------------------------
---------------------------------------------
---------------------------------------------
---------------------------------------------
---------------------------------------------
---------------------------------------------
----------------------------------##---------
---------------------------------###---------
--------------------------------####---------
-------------------------------#####---------
-----SSS------TT--------------######---------
--------------TT-------------#######---------
--------------TT------------########--------F
--M-----------TT-------ggg-#########--------#
XXXXXXXXXXXXXXXXXXXXXXXXXXXXXXXXXXXXXXXXXXXXX
XXXXXXXXXXXXXXXXXXXXXXXXXXXXXXXXXXXXXXXXXXXXX
