--------------------------------------------------------------------------------------------------------------------------------------------------------------------------------------------------------------------------------------------
--------------------------------------------------------------------------------------------------------------------------------------------------------------------------------------------------------------------------------------------
--------------------------------------------------------------------------------------------------------------------------------------------------------------------------------------------------------------------------------------------
--------------------------------------------------------------------------------------------------------------------------------------------------------------------------------------------------------------------------------------------
---------------------------------------------------------------------------------------------------------------------------------------------------------------------TT---------------------------------------------------------------------
---------------------------------------------------------------------------------------------------------------------------------------------------------------------TT---------------------------------------------------------g##---------
---------------------LSSS---------------------!!!!!-----------USSS------LSSS---------------------!!!!!-----------USSS------!------------------------------------2----##--------------------------------------------------------g###---------
----------------------------------------------------------------------------------------------------------------------------------------------------@-------------------------------------------------------------------------g####---------
-----------------g-----------------------------------------------------------------------------------------------------------------------------------------------------------------------------------------------K------------#####---------
-----------------#------------------------------k--------------------------------------------------k-----------------------------oooo----------------------------2-------------------oo---------------------------###-----#--######---------
--------SUS-----##---2-----#-----------TT-----@!!!!----------S-----TT---2-----#-----------TT-----@!!!!----------S-----TT---2------------------------C------------------------------------#----------------------------------#######---------
---------------###---------#-----------TT--------------------------TT---------#-----------TT--------------------------TT------------------------TT---------------------------#-----------#------TT-------------------------########--------F
--------------####---------##----------TT--------------------------TT---------##----------TT--------------------------TT------------------------TT---#----tt-----------------#----kk-----#------TT-----r----gg------------#########--------#
--M----------#####----kk---##---gg-----TT------------gg----k-ggg---TT----kk---##---gg-----TT------------gg----k-ggg---TT----y---------kkk-------TTk--#----tt---r-------------XXXXXXXXXXXXXXXXXXXXX--XXXXXXXXXXXXX--------XXXXXXXXXXXXXXXXXXX
XXXXXXXXXXXXXXXXXXXXXXXXXXXXXXXXXXXXXXXXXXXXXXXXXXXXXXXXXXXXXXXXXXXXXXXXXXXXXXXXXXXXXXXXXXXXXXXXXXXXXXXXXXXXXXXXXXXXXXXXXXXXXXXXXXXXXXXXXXXXXXXXXXXXXX----XXXXXXXXX----------XXXXXXXXXXXXXXXXXXXXX--XXXXXXXXXXXXX--------XXXXXXXXXXXXXXXXXXX
XXXXXXXXXXXXXXXXXXXXXXXXXXXXXXXXXXXXXXXXXXXXXXXXXXXXXXXXXXXXXXXXXXXXXXXXXXXXXXXXXXXXXXXXXXXXXXXXXXXXXXXXXXXXXXXXXXXXXXXXXXXXXXXXXXXXXXXXXXXXXXXXXXXXXX----XXXXXXXXX-------------------------------------------------------------------------
