----r-----------r-or-o-----r----------------------------------------
------------------%-------r-----------------------------------------
-----------------%|go-------------------------oo--oo----------------
------------------|r-----r-%------r----------------------------r----
------o--------r--||--%-rr%------------o----------------------------
-------o--------r-||o--%%%|------------S-----------SSr----Sr--------
------S-----------||---||||------SS-----S-------------------SSSS----
------------------||---||||--------S-----------SSS------------------
------------%r----||---||||-----------------------------------------
--------%%%%rrr---||---||||--%%--------------------r----------------
---------||||%%%%%%%---||||---|r-----------------------------r-rr--F
---------||||||||-||---||||----r------------------------XXXXXXXXXXXX
---------|||||---------|||------------------------------XXXXXXXXXXXX
--M-r--X-|||||------------------------------------------------------
XXXXX--X------------o-----------------------------------------------
XXXXX--------------------rr-----------------------------------------
