----------------------------------------------------------------------------------------------------------------------------------------------
----------------------------------------------------------------------------------------------------------------------------------------------
----------------------------------------------------------------------------------------------------------------------------------------------
----------------------------------------------------------------------------------------------------------------------------------------------
----------------------------------------------------------------------------------------------------------------------------------------------
----------------------------------------------------------------------------------------------------------------------------------------------
---------------------LSSS---------------------!!!!!-----------USSS-----------------------------------------------------------------##---------
----------------------------------------------------------------------------------------------------------------------------------###---------
-----------------g---------------------------------------------------------------------------------------------------------------####---------
-----------------#------------------------------k-------------------------------------------------------------------------------#####---------
--------SUS-----##---2-----#-----------TT-----@!!!!----------S-----TT---!!!!---------------------------------------------------######---------
---------------###---------#-----------TT--------------------------TT--------KS-----------------#-----------------------------#######---------
--------------####---------##----------TT--------------------------TT----------------------B----#----------------------------########--------F
--M----------#####----kk---##---gg-----TT------------gg----k-ggg---TT---------------ggg----b----#----ggg--k----ggg------ggg-#########--------#
XXXXXXXXXXXXXXXXXXXXXXXXXXXXXXXXXXXXXXXXXXXXXXXXXXXXXXXXXXXXXXXXXXXXXXXXXXXXXXXXXXXXXXXXXXXXXX--XXXXXXXXXXXXXXXXXXXXXXXXXXXXXXXXXXXXXXXXXXXXXX
XXXXXXXXXXXXXXXXXXXXXXXXXXXXXXXXXXXXXXXXXXXXXXXXXXXXXXXXXXXXXXXXXXXXXXXXXXXXXXXXXXXXXXXXXXXXXX--XXXXXXXXXXXXXXXXXXXXXXXXXXXXXXXXXXXXXXXXXXXXXX
