--------------------------------------------------------------------------------------------
--------------------------------------------------------------------------------------------
--------------------------------------------------------------------------------------------
---------------------------------------------------------------U----------------------------
--------------------------------------------------------------------------------------------
---------------------------------------------------------------------------------y----------
---------------------LSSS---------------------SSSSS------------------------------##---------
-----------------------------------------------------------------SS-------------###---------
-----------------g----------------------------------------------------#--------####---------
-----------------#-----------------------------K-------------SS------##-------#####---------
--------SUS-----##---2-----#------------------SSSSS-----------------###------######---C-----
---------------###---------#------B--------------K---#----B--------####-----#######---------
--------------####---------##-----b-----TT-----------#----b-------#####----########--------F
--M----------#####----kk---##-----b-----TT-----------#----B------######---#########--------#
XXXXXXXXXXXXXXXXXXXXXXXXXXXXXXXXXXXXXXXXXXXXXXXXXXXXXXXXXXXXXXXX-XXXXXXXXXXXXXXXXXXXXXXXXXXX
XXXXXXXXXXXXXXXXXXXXXXXXXXXXXXXXXXXXXXXXXXXXXXXXXXXXXXXXXXXXXXXX-XXXXXXXXXXXXXXXXXXXXXXXXXXX
