---------------------------------------------------------------------------------------------------------------------------------------------------------------------------------------------------------------------------XXXXXXXXXXXXXXXXXXXXXXXXXXXXXXXXXXXXXXXXXXXXXXXXX-X-XX-X-XX-XXXXXXXXXXXXXXXXX-X-X-XXXXXXXXXXXXXXXXXXX------XXXXXXXXXX-XX--XX--XXXXXXXXXXXXXXXXXXXXXXXXXXXXXXXXXXXXXXX-
-------------------------------------------------------------------------------------------------------------------------------------------------------------------------------------------------------------------------------------------------------------------------------------------------------------------------------------------------------------------------------------------------
-------------------------------------------------------------------------------------------------------------------------------------------------------------------------------------------------------------------------------------------------------------------------------------------------------------------------------------------------------------------------------------------------
--------------------------------------------------------------------U----------------------------------------------------------------------------------------------------------------------------------------------------------------------------------------------------------------------------------------------------------------------------------------------------------------------------
-------------------------------------------------------------------------------------------------------------------------------------------------------------------------------------------------------------------------------------------------------------------------------------------------------------------------------------------------------------------------------------------------
-----------------------------------------------------------------------------------------ooo-----------------------------------------------------------------------------------------------------------------------------------------------------------------------------------------------------------------------------------------------------------------------------------------------------
---------------------LSSS--------------------------SSSSS-----------------------------------------------------------------------------------------------------------------------------------------------------------------------------------------------------------------------------------------------------------------------------------------------------------------------------------------
----------------------------------------------------------------------SS-----------------------------------------S--------------------------------1SSSSSSSSSSSSSSSSSSSSS------------------------------------------------TT-------------------------------------SSSSCSSS---------------------------------------------------------------------------------------------------------------##---------
-----------------g---------------------------------------------------------#---------B----------------------------------------------------------------------------------------------------------------------------------TT------------------------------------------------------------------------------------------------------------------------------------------------------------##---------
-----------------#----------------------------------K-------------SS------##---------b-----------------------------------------------------------------------------------------------------------------------------B----TT------------------------------------------------------------------------------------------------------------------------------------------------------------##---------
--------SUS-----##---2-----#-----------------------SSSSS-----------------###-------####--------------------------------------------------------------------------------------------------------X@---------SS------S#2---XX-------------------------------------------------------------------SSUSSSSS--------------S----------------oo---------------------tt------------------K---#--##---------
---------------###---------#------TT------------------K---#----B--------####------##-----------------------------------------------------------------------K--K----------SS--------------B--------------------------------------------------------------------#----2----#------------------------------------------------------------------------------TT--tt------S--------------##--##---------
--------------####---------##-----TT--#------TT-----------#----b------g#####-----###-----------------------------#--------------------------------#------------------------------B-----K-bK----------B--------------------------------------------------------#------K--#-------K------------------------------------------------------------------TT--TT--tt--------------------###--##---------
--M----------#####----kk---##-----TT---------TT-----------#----B------######---#####----k-----S-------#---kgg----#-------k-----kkk-------kk----#---------------------------------b-------B-----------b--y------B--y-y-----------------------------------------#---------#-----------K----------------------------------#---------------------------TT--TT--tt-------------------####------------F
XXXXXXXXXXXXXXXXXXXXXXXXXXXXXXXXXXXXXXXXXXXXXXXXXXXXXXXXXXXXXXXXXXXXX-XXXXXXXXXXXXXXXXXXXXXXXXX---XXXXXXXXXXXX--XXX--XXXXXXXXXXXXXXXXXXXXXXXXXXXXXX-XXXXXX-XXXXXXXXXXXXXXX--XXXX-XXXXXXXXXXXXXXXXXXXXXXXXXXXXXXXXXXXXXXXXXXX-----gg-----ggg------gg------gg#-##---------#--------------------------------------------kk#----------------------ggg--TT--TT--tt-------b----T-----#####------------#
XXXXXXXXXXXXXXXXXXXXXXXXXXXXXXXXXXXXXXXXXXXXXXXXXXXXXXXXXXXXXXXXXXXXX-XXXXXXXXXXXXXXXXXXXXXXXXX---XXXXXXXXXXXXX-XXX--XXXXXXXXXXXXXXXXXXXXXXXXXXXXXX-XXXXXX-XXXXXXXXXXXXXXX--XXXX-XXXXXXXXXXXXXXXXXXXXXXXXXXXXXXXXXXXXXXXXXX-XXXXXXXXXXXXXXXXXXXXXXXXXXXXXXXXXXXXXXXXXXXXXXXXX-X-XX-X-XX-XXXXXXXXXXXXXXXXX-X-X-XXXXXXXXXXXXXXXXXXX------XXXXXXXXXX-XX--XX--XXXXXXXXXXXXXXXXXXXXXXXXXXXXXXXXXXXXXXX
