------------------------------------------------------------------------------------------------------------------------------------------------------
------------------------------------------------------------------------------------------------------------------------------------------------------
------------------------------------------------------------------------------------------------------------------------------------------------------
------------------------------------------------------------------------------------------------------------------------------------------------------
------------------------------------------------------------------------------------------------------------------------------------------------------
------------------------------------------------------------------------------------------------------------------------------------------------------
--------------------------------US-----------------------------------------------------y---------------------2----------------------------------------
-------------------------------------------------------------------------------------#SSS-------------------------------------------------------------
------------------------------------------------------------------------oo----------##------------------------------------y---------------------#SS-@!
--------------------------------------------------------------------y--------------###1--------------ooo------------------XSS-@!---------------##-----
------------!!-----------------####--SSC------------------ooo-------##-------------###-----------------------2-----------XX-------------------###-----
--------------------------y-#####----------------------------------###-----------#-###--SSS-------TT--------------------XXX------------------####-----
-----------------------y-######-----------------------------------####----------##-###------------TT-------------------XXXX-------y---------#####---SS
----------------------#######------------------y-y---------------#####-------------###---------y--TT-------y--y-------XXXXX---SSSSS-----y--######-----
XXXXXXXXXXXXXXXX--XXXXXXXXX------XX--XXXXXXXXXXXXXXXX--XXXXXXXXXXXXXXX---XXXXXXXXXXXXXXXX---XXXXXXXXXXXXXXXXXXXXXXXXXXXXXXX-------XX-XXXXXXXXXXXX-----
XXXXXXXXXXXXXXXX--XXXXXXXXX------XX--XXXXXXXXXXXXXXXX--XXXXXXXXXXXXXXX---XXXXXXXXXXXXXXXX---XXXXXXXXXXXXXXXXXXXXXXXXXXXXXXX-------XX-XXXXXXXXXXXX-----
