--------------------------------------------------------------------------------------------------------------------------------------------
--------------------------------------------------------------------------------------------------------------------------------------------
--------------------------------------------------------------------------------------------------------------------------------------------
-----------------------------------------------------------------------------------------------------------U--------------------------------
---------------------------------------------------------------------------------------------------------------------------------k----------
----------------------------------------------------------------------------------g--------------------------T---SS--------------##---------
-----------------------------US-------------------------------------------------SSSSSSSS---SSS!--------------T------------------###---------
-------------------------------------------------------------------------------------------------------------#--------#--------####---------
---------------------------------------------------------------------oo--------g----------------------------------X--##-------#####---------
-----------------------------------------------------------------y---------------------------------------SS-------X####------######---------
---------!!-----------------####--SSC------------------ooo-------##----------S@S--------------C-------------------X####-----#######---------
-----------------------y-#####----------------------------------###-----------------------------------B-----------X####----########--------F
--------------------y-######-----------------------------------####-----------------------------------b---------##X####---#########--------#
--M----------------#######------------------y-y---------------#####----------------------------g-g----B--------XXXXXXXXXXXXXXXXXXXXXXXXXXXXX
XXXXXXXXXXXXX--XXXXXXXXX------XX--XXXXXXXXXXXXXXXX--XXXXXXXXXXXXXXX---XXXXXXXXXXXXXXXX---XXXXXXXXXXXXXXXXXXX---XXXXXXXXXXXXXXXXXXXXXXXXXXXXX
XXXXXXXXXXXXX--XXXXXXXXX------XX--XXXXXXXXXXXXXXXX--XXXXXXXXXXXXXXX---XXXXXXXXXXXXXXXX---XXXXXXXXXXXXXXXXXXX--------------------------------
