------------------------------------------------------------------------------------------------------------------
------------------------------------------------------------------------------------------------------------------
------------------------------------------------------------------------------------------------------------------
------------------------------------------------------------------------------------------------------------------
------------------------------------------------------------------------------------------------------------------
------------------------------------------------------------------------------------------------------------------
---------------------LSSS------------------------------------------------------------------------------##---------
------------------------------------------------------------------------oooo--------------------------###---------
-----------------g-----------------------------------------------------------------------------------####---------
-----------------#-------------------------1--------------------------------------------------------#####---------
--------SUS-----##---2-----#-----------TT----------------------------------------------------------######---------
---------------###---------#-----------TT-------B------------------------TT-----------------------#######---------
--------------####---------##----------TT-------b------------------------TT----------------------########--------F
--M----------#####----kk---##---gg-----TT-------B----kkk----------kkk----TT----k---ggg------ggg-#########--------#
XXXXXXXXXXXXXXXXXXXXXXXXXXXXXXXXXXXXXXXXXXXXXXXXXXXXXXXXXXXXXXXXXXXXXXXXXXXXXXXXXXXXXXXXXXXXXXXXXXXXXXXXXXXXXXXXXX
XXXXXXXXXXXXXXXXXXXXXXXXXXXXXXXXXXXXXXXXXXXXXXXXXXXXXXXXXXXXXXXXXXXXXXXXXXXXXXXXXXXXXXXXXXXXXXXXXXXXXXXXXXXXXXXXXX
