-------------------------------------------------------------------------------------------------------------------------------------------------------------------------------------------------------XX---------------------------------------------------------------------------------------------------------------------------------
------------------------------------------------------------------------------------------------------------------------------------------------------------------------------------------------------------------------------------------------------------------------------------------------------------------------------------------
-------------------------------------------------------------------------------------------------------------------------------------------------------------------------------------------------------------------------------------------------------------------------------------------------------------------------------y----------
---------------------------------------------------------------------------------------------------------------------------------------------------------------------------------------------------------------------------------------------------------------------------------------------------------SSSSS@----------------##---------
------------------------------------------------------------------------------------------------------------------------------------------------------------------------------------------------TT----------------------------------------------------oooo-------------------------------------------------------------------y###---------
--------------------------------------------------------------------------------------------------------k---------------------------------------------------------------------------------------TT-----------------------------------------------------k---------------------------------------------------------------------####---------
---------------------LSSS---------------------!!!-----------------------------------------------------------------------------------------------------------------------------------------r2----##-------------------------------------------------------------------------------------------------------ooo----------------#####---------
---------------------------------------------------------------------------------------------------------------------------k---------------------------------------------------@-------------------------------------------------------------------------------------------------------------------------SSSSSS---------k--######---------
-----------------k-----------------------------------------------y---------------------#SS--------------------k---------------------@------------------------------------------------------------------------------------------------------------------TT-----------------------------------------TT---------------------k#######---------
-----------------#----------------------k-------kk---------------XSS-@!---------------##---------------oooooo-----------------------------------------------oooo----------------------------2---------------------------------k------------------------TT-----------------------------------------TT---------------------########--------F
-----S--SUS-----##---------#-----------TT-----@!!---------------XX-------------------###----##---------------------------------------------------ooo----------------------k----C-------------------------#--------k-----kkkk------kk-k-----k--kkkkk----TT----k---kgg---k--gg--k----k-gg----T-k--kkTk--------------------y########-----k-k#
---------------###---------#-----------TT----------------------XXX------------------####----###---------------------------K------------------------------------------------TT---------------------------------XXXXXXXXXXXXXXXXXXXXXXXXXXXXXXXXXXXXXXXXXXXXXXXXXXXXXXXXXXXXXXXXXXXXXXXXXXXXXXXXXXXXXXXXX--XXXXXXXXXXXXXXXXXXXXXXXXXXXXXXXXX
--------------####---------##----------TT--------------B------kXXX-------y-k-------#####----####----------------------r-------------y--------------------------------------TT---#----tt------------------------XXXXXXXXXXXXXXXXXXXXXXXXXXXXXXXXXXXXXXXXXXXXXXXXXXXXXXXXXXXXXXXrXXXXXXXXXXXXXXXXXXXXXXXX--XXXXXXXXXXXXXXXXXXXXXXXXXXXXXXXXX
--M----------#####----kk---##---gg-----TT--------------br----TkXXX---SSSSS-----y--######----#####-----TT-----##-k--gg------k----#-----------k-kkk--k-kkkk----k---kkk--k----kTk--#----tt-r-k-----------------------------------------------------------------------------------------------------------------------------------------------
XXXXXXXXXXXXXXXXXXXXXXXXXXXXXXXXXXXXXXXXXXXXXXXXXXXXXXXXXXXXXXXXXX-------XX-XXXXXXXXXXXX----XXXXXX----TT------XXXXXXXXXXXXXXXXXXX---X--XXXXXXXXXXXXXXXkXXXXXXXXXXXXXXXXXXXXXXXXXX----XXXXXXXXX--------------------------------------------------------------------------------------------------------------------------------------------
XXXXXXXXXXXXXXXXXXXXXXXXXXXXXrXXXXXXXXXXXXXXXXXXXXXXXXXXXXXXXXXXXX-------XX-XXXXXXXXXXXX----XXXXXX----TT------XXXXXXXXXXXXXXXXXXX------XXXXXXXXXXXXXXXXXXXXXXXXXXXXXXXXXXXXXXXXXX----XXXXXXXXX----------XX--------------------------------------------------------------------------------------------------------------------------------
