-----------------------------------------------------------r-------r-------------------------------rS---S-SSSSSSSSSS-----------------------------------------------------------------r----------------------------------r--------------r---r-----------------------------------------------------------------------------------------r-----r-------TT-----#-r-----#-##------------#-XXX-XXXXXXX---rXXXXXXX-X-X-X
---------------------r---------------r-----------------r---------r-------------r-------@----#----rrS----------------------------------------------------------------------@----------2------------------------------------------------------------------------------------------------------------------------------------S------------------------TT-----#------##r##----#-------XXX---------X----X------------
-----------r--------------------------------r-----------U--r---r-------T-------------------##--oo---------------------------------------------oo-----------------------------------------k---o--r-------------ggg--------------------------------------------------------------TT--------------------S---g---------------S---------------------rr--TTr-X--XXXXXXXXXXXXXXXXXXXX----XX----------------------------
--------------------------------------r--r---------------SU------------#------------------###-------------r-------k------TT---@---@-----------------r-----------r------------------------TT-------------##########---#-------K---#-----------------------------------#---------TT---------------------####------------------------------r----r-XXXXXXXXX--XXXXXXXXXXXXXXXXXXXX----------------------r-----------
-------------------------------------------rr--------------S---------###-----------------####---------------------CC-----TT-----r-----------------------rr------T------r--r-----#--------TT------------##--------#---#-----------#-----r-----------------#---------r-----------TT----#-kk---r-----------------------K----------------------B-X-XXXXXXXX---------------------------------------r-----------r-----
--------------------rr---------r------rSSr-CC-----------#------------#-----------------######------r---------------------TTr----#------B------------r-g-----r--gT-----y---rkr---b--r-----TT-----------###--------#---##----------#-------------B--------###-B--XXXXXXX--r-----gTT-XXXXXXX--XXXXr--g---------TT------------#----------------b-X-----------------------------------------r----------r-------------
----------------------------2-------r------------------@#----------r-#--X----------#---######--k-------------------------TT----####-rr-b-r--r----r-XXXXXXXXXXXXXXXXXXXXXXXXXXXX-XXXXXX---TT----rrr---####--------#---###r----XX--XXXXXXX--gg---b--r--g-###r-b-XXXXXXXXr----r-XXXXXXXXXXXXXXXXXXXXXXXX-------TT----r-------#-r--r--gr#r--yr-b-----------r------------------r---------------------r-r----r--------
--------------r------------------------------------------r-----------#-XXr----XXXXXX---XXXXXXXXXXXXXXXX------#-----krrr--XXX--r#XXXXXXXXXXXXXXXXXX-XXXXXXXXXXXXXXXXXXXXXXXXXXXX-XXXXXXXXXXXXXXXXXXXXXXXXX--------X---XXXXXXXXXX--XXXXXXXXXXXXXXXXXXXXXXXXXX-XXXX--------XXXXXXXXXX-------XX----XXXXXXr------TT---yXXXXXX--XXXXXXXXXXXXXXXXXXX-----------------------------------------------------------2-------
------------#SS--------------------------------------------r-------#-XXX----XXXXXXXX---XXXXXXXXXXXXXXXX------XXXXXXXXXXXXXXX-XXXXXXXXXXXXXXXXXXXXX-------r-----------------------------XXXXXXXXXXXXXXXXXX--------X---XXXXXXXX-----------XXXXXXXXXXXXXXXXXXX-XX-r--------XXXXX-------------------------------XXXXXXXXXXXX--XXXXXXXXXXXXXXXXXXX----------r----------------------------r-r-------------------------
-----------##----------------2--------T---------r------r-------r----XXX-----XX-------------------------------XXXXXXXXXXXXr---XXX--r-----------------------------------------------------------------------------------r-----------------------------------------------------------r-------------------------XXXXXX-----------------------r---r------------------------------------------------------------------
----------###------------------------TT--------XXXXX-X-XXX--XX----X-X---------------------------------------------------------------------r---r----------r-------r------------------------------------------------------------------------r-------------------r--------------r-----------------r--------------------------------------------------------------r------##----r-------rT-S-------------------------
---------####----------r-------------TT--------XXXXX-X-XXXXXXX-XXXX---------------------r---------------------------------------r----------------------------------------------------------------r-----------------------r-----r----------------------------r---------------------------------------------------------------------------------r----------------------##-------------TS-------------------------#
--------#####-----------r------TT----TT--------------------X--rXXX----------r------------------------------------------------------------------------------------------------------------------------------------------------------------------------------r-----------------r----------r--r-------r-r------r---------------------------------r----------------------##-------------X-------r---#S-------------#
--M-r--######------r--XXr--r---TT----TX---------------------------------r-------------------------------------------------------------------------------------------r---------------------------------------------r----------r---------------------------------------------------------r--------------------r--------------------------------------------------------##----------------------r--r------------#-#
XXXXXXXXXXXXX----XXXXXXXXXXXXXXXXXXXXXX----------------------r---------r1-----r-------------------------r-------------------------------r-----------r-------------SSSS---------r-----2----------------------------------------------------------r-----------------------------------------------------------------r-r---r-r----------------------------------------r-##----rS#--------r--r-------------r-----#-#
XXXXXXXXXXXXX----XXXXX--XXXXXXXXXXXXXX--------------r--------------r-----------------------------r---rSSSr----------r----r--------------------2-------------------------------------------r---r---r------------1---------------------r-------------------------------r---------------------------------------rr-------2--r---r----------------------TT-----#-------r-##------------#--XX-XXXXXX#-----XXXXXXrX-X-
