-------------------------------------------------------------------------------------------------------------------------------------------------------------------------------
-------------------------------------------------------------------------------------------------------------------------------------------------------------------------------
-------------------------------------------------------------------------------------------------------------------------------------------------------------------------------
-------------------------------------------------------------------------------------------------------------------------------------------------------------------------------
-------------------------------------------------------------------------------------------------------------------------------------------------------------------------------
-------------------------------------------------------------------------------------------------------------------------------------------------------------------------------
---------------------LSSS---------------------!!!!!----------gUSSS--------SSCSS------SSSS-----------------------------USSS------------------------------------------##---------
---------------------------------------------------------------------------------g---------------------------------------------------------------------------------g##---------
-----------------g---------------------------------------------------------------------------------------------------------g--------------------------------------####---------
-----------------#------------------------------kk-------------------------------g--------------g--------------------------TT------------------------------------#####---------
---------US-----##---2-----#-----------TT-----@!!!!----------S-----TT---!!!!--!!!---------------TT-----------------TT------TT-----------------o----------------g######---------
---------------###---------#-----------TT--------------------------TT---------------------------TT----------g------TT--tt--TT---------------------------------g#######---------
--------------####---------##----------TT--------------------------TT---------------------------TT----------TTg----TT--tt--TT------------------K--------------########--------F
--M----------####-----kk---b#-g-kg-g-g-TT------------gg----k-ggg---TT---------g--ggg------------TT----------TT--g-gTT--tt--TT---g-k----g----gg-gggg-----gggg-#########-----k--#
XXXXXXXXXXXXXXXXXXXXXXXXXXXXXXXXXXXXXXXXXXXXXXXXXXXXXXXXXXXXXXXXXXXXXXXXXXXXXXXXXXXXX----XXXXXXXXXX---XXXXXXXXXXXXXXXXXXXXXXXXXXXXXX---XXXXXXXXXXXXXXXXXXXXXXXXXXXXXXXXXXXXXXXX
XXXXXXXXXXXXXXXXXXXXXXXXXXXXXXXXXXXXXXXXXXXXXXXXXXXXXXXXXXXXXXXXXXXXXXXXXXXXXXXXXXXXX----XXXXXXXXXX---XXXXXXXXXXXXXXXXXXXXXXXXXXXXXX---XXXXXXXXXXXXXXXXXXXXXXXXXXXXXXXXXXXXXXXX
