--------------------------------------------------------------------------------------------------------------------------------------------------------------------------------------------------------------------------------------------
--------------------------------------------------------------------------------------------------------------------------------------------------------------------------------------------------------------------------------------------
--------------------------------------------------------------------------------------------------------------------------------------------------------------------------------------------------------------------------------------------
--------------------------------------------------------------------------------------------------------------------------------------------------------------------------------------------------------------------------------------------
-----------------------------------------------------------------------------------------------------------------------US---------------------------------------LSSS-----------------------C-------------------------------------##---------
---------------------------------------------------------------K----------------------------------------------------------------------------------------------------------------------------------------------------------------###---------
-----------------------------USSSSSSSSSSSS---@-------------SSSSSS----1---------------------------------------------1----------------------------------------g-----------------------------------------oo-----------------------####---------
------------------------------------------------------------------------------------------------------------------------------------------------------------#-------------------------------------y---------------------------#####---------
----------------------------------------------------------------------------------------------------------------------####--SSC------------------ooo-------##---2-----#-----------TT------SS------##----------S!S------------######---------
------------------------------------------------------------K------------------------------------------------------gg###----------------------------------###---------#-----------TT-------------###------------------------#######---------
---------!!-----------------###------------!--------------SSSSSSS-----------------------------S--------------#########-----------------------------------####---------##----------TT------------g###--------------------tt-########--------F
-----------------------y-#####-------------------TT------------------TT---------g---K-----TT----------------##------------------------y-y---------------#####----kk---##---gg-----TT-------k---X####---------------gg---tt#########--------#
--------------------y-######---------------------TT------------------TT---------TT--------TT--------TT-----###----------XX--XXXXXXXXXXXXXXXX--XXXXXXXXXXXXXXXXXXXXXXXXXXXXXXXXXXXXXXXXXXXXXXXXXXXXXX---XXXXXXXXXXXXXXXXXXXXXXXXXXXXXXXXXXXXX
--M----------------#######----------------K-K----TT------------------TT---------TT-----gggTT------k-TT----####----------XX--XXXXXXXXXXXXXXXX--XXXXXXXXXXXXXXXXXXXXXXXXXXXXXXXXXXXXXXXXXXXXXXXXXXXXXX---XXXXXXXXXXXXXXXXXXXXXXXXXXXXXXXXXXXXX
XXXXXXXXXXXXX--XXXXXXXXX------XXXXXXXXXXXXXXXXXXXXXXXXXXXXXXXXXXXXXXXXXXXXXXXXXXXXXXXXXXXXXXXXXXXXXXXXXXXXXXXX------------------------------------------------------------------------------------------------------------------------------
XXXXXXXXXXXXX--XXXXXXXXX------XXXXXXXXXXXXXXXXXXXXXXXXXXXXXXXXXXXXXXXXXXXXXXXXXXXXXXXXXXXXXXXXXXXXXXXXXXXXXXXX------------------------------------------------------------------------------------------------------------------------------
