---------------------------------------------------------------------------------------------------------------------
---------------------------------------------------------------------------------------------------------------------
---------------------------------------------------------------------------------------------------------------------
---------------------------------------------------------------------------------------------------------------------
---------------------------------------------------------------------------------------------------------------------
---------------------------------------------------------------------------------------------------------------------
------------------------------------------SUS-------------------------------------------------------------##---------
---------------------------------------------------------------------------------------------------------###---------
--------------------------------------------------------------------------------------------------------####---------
-------------------------------------------------------------------------------------------------------#####---------
-----------------------------------------#####--------------------------------------------------------######---------
-------K---------------------------------#--------------------------#--------------------------------#######---------
----------------------------------------K#---------------------*----#-------------------------------########--------F
--M-----------ggg-------ggg--------------#--------------ggg----*----#----ggg--k----ggg-----------kk#########--------#
XXXXXXXXXXXXXXXXXXXXXXXXXXXXXXXXXXXXXXXXXXXX----XXXXXXXXXXXXXXXXXX--XXXXXXXXXXXXXXXXXXXXXXXXXXXXXXXXXXXXXXXXXXXXXXXXX
XXXXXXXXXXXXXXXXXXXXXXXXXXXXXXXXXXXXXXXXXXXX----XXXXXXXXXXXXXXXXXX--XXXXXXXXXXXXXXXXXXXXXXXXXXXXXXXXXXXXXXXXXXXXXXXXX
