-------------------------------------------------------------------------------------------------------------------------------------------------------------------------------
-------------------------------------------------------------------------------------------------------------------------------------------------------------------------------
-------------------------------------------------------------------------------------------------------------------------------------------------------------------------------
-------------------------------------------------------------------------------------------------------------------------------------------------------------------------------
-------------------------------------------------------------------------------------------------------------------------------------------------------------------------------
------------------------------------------------------oo-----------------------------------K-----------------------------------------------------------------------------------
------------------!----------------------------------SSS---------------------------------SSSSSSS@-------------------------------r----------------------------------------------
-----------------------------------------------------------------------------------------------------------------------------SSSSS--------------CCSS----------------##---------
------------------------------------##---------------------------------------------------------------------------------------------------------------------------K-###---------
-----------------------------------###------------------SSS-----------------------------------K--------------------------------------------------------------------###---------
--------S---------@-------------#--###-------@@@@@-D-------------------------------------SSSSSSSS-------------------------------------------@--------------------#-###---------
--------------TT------TT------g##--###----------------------------------K---------------------------#------------------SSS---------------KK---------------------##-###---------
--------------TT------TT------###--###------------------------------------B-----------TT------------#------------C@------------------------------TT-----------#-##-###--------F
--M-----------TT-------T-----####--###-----------K------oo-------------g--b-ggg-------TT------------#----yyy-------------------gg----------------TT----------g#-##-###--------#
XXXXXXXXXXXXXXXXXXXXXXXXXXXXXXXXX--XXXXXXXXXXXXXXXXXXXXXXXX----XXXXXXXXXXXXXXXXXXXXXXXXXXXXXXXXXXX--XXXXXXXXXXXXXXXX-------XXXXXXXXXXXXXXXXXXX---XX--XXXXXXXXXX-XX-XXXXXXXXXXXX
XXXXXXXXXXXXXX-XXXXXXXXXXXXXXXXXX--XXXXXXXXXXXXXXXXXXXXXXXX----XXXXXXXXXXXXXXXXXXXXXXXXXXXXXXXXXXX--XXXXXXXXXXXXXXXX-------XXXXXXXXXXXXXXXXXXX---XX--XXXXXXXXXX-XX-XXXXXXXXXXXX
