---------------------------------------------------------------------------------------------------------------------
---------------------------------------------------------------------------------------------------------------------
---------------------------------------------------------------------------------------------------------------------
---------------------------------------------------------------------------------------------------------------------
---------------------------------------------------------------------------------------------------------------------
---------------------------------K-----------------------------------------------------------------------------------
-------------------------------SSSSSSS@-------------------------------r----------------------------------------------
-------------------------------------------------------------------SSSSS--------------CCSS----------------##---------
-------------------------------------------------------------------------------------------------------K-###---------
------------------------------------K--------------------------------------------------------------------###---------
-----SSS-----------------------SSSSSSSS-------------------------------------------@--------------------#-###---------
--------------K---------------------------#------------------SSS---------------KK---------------------##-###---------
----------------B-----------TT------------#------------C@------------------------------TT-----------#-##-###--------F
--M-------------b-ggg-------TT------------#----***-------------------gg----------------TT----------##-##-###--------#
XXXXXXXXXXXXXXXXXXXXXXXXXXXXXXXXXXXXXXXX--XXXXXXXXXXXXXXXX-------XXXXXXXXXXXXXXXXXXX---XX--XXXXXXXXXX-XX-XXXXXXXXXXXX
XXXXXXXXXXXXXXXXXXXXXXXXXXXXXXXXXXXXXXXX--XXXXXXXXXXXXXXXX-------XXXXXXXXXXXXXXXXXXX---XX--XXXXXXXXXX-XX-XXXXXXXXXXXX
