------------------------------------------------------------------------------------------------------------------------------------------------------
------------------------------------------------------------------------------------------------------------------------------------------------------
------------------------------------------------------------------------------------------------------------------------------------------------------
------------------------------------------------------------------------------------------------------------------------------------------------------
------------------------------------------------------------------------------------------------------------------------------------------------------
------------------------------------------------------------------------------------------------------------------------------------------------------
-------------------------------------CS-----------C----!!!--------------------------------------S!S!-!!!----------------------------SSSS1-T-----------
--------------------------------------------------------------------------------------------------------S---------oooo--------------------T-----------
------------------------------------------------------------------------------------------------------------------------------------------T-----------
----------------------------------------TT--------k-----y---------------o---TT----o-----oo-------------------------------------------K----#-----------
--------------!!--------------------SS--TT------S@S---SSS!!!----------------TT------------------!!!!-!!!-------TT-------------------SSSSS----TT-------
------------------TT--------------------TT--------------------K-------------TT---------------------------------TT---------TT-----------------TT-------
------------------TT--------------------TT-----------------------TT---------TT--------------------------*------TT---------TT----tt----------TTT-----TT
------------------TT---ggg-----------k--TT-----------------------TT---------TT--------------------------*------TT---------TT--g-tt--------XgTTT----XTT
XXXXXXXXXXXXXXXXXXXXXXXXXXXXXXXXXXXXXX|XXXXXXXXXXXXXXXX--XXXXXXXXXXXXXXXXXXXXXXXXXXXXXX----XXXXXXXXXXXXXXXXXXXXXXXXXXXXXXXXXXXXXXXXXXXXXX-XXXXXXXXXXXX
XXXXXXXXXXXXXXXXXXXXXXXXXXXXXXXXXXXXXXXXXXXXXXXXXXXXXXX--XXXXXXXXXXXXXXXXXXXXXXXXXXXXXX----XXXXXXXXXXXXXXXXXXXXXXXXXXXXXXXXXXXXXXXXXXXXXX--XXXXXXXXXXX
