-------------XXXXX----------M------#t-----------------S---X--S####X#---SSSSS-SSSSS-SSS-SS-SSSS-SSS--S--------------S---S----------S-SSSSSSSS-SSS------
----o--------XXXXX-XXXXXXXXXXXX---F#t-----------B---------X--SXXXXXXX--SS-----S-SS-SSS----SSSX-SSS-----------SS----S--------------S--S----SS--S-------
-------------------XXXXXXXXXXXX---B#t-y---------b---------Xg-SXXXXXXX--SS-----S--S-SSS--S-SSS*-S------------------g---#-XX-S------S--S----SSX-S-------
---------------------------------XXXXXXXXXXXXXXXXXXX------XS-X---------SS-----S--S-SSSS-S-SSSS---S----------------XXXXXXXX-S-SSSS-S--SS-U-SSX!S-S----X
---------------------------------XXXXXXXXXXXXXXXXXXX-----SX--X---------S-------------S--S-S-S---------------------XXXXXX---SSS-------SS----SXSoSS---XX
----------------------------------------------------------X----------SSS-------------S--S-S-S---S-------S--------S---------XSS--S----SS----SX--SSXXXX-
-------------------S--------S-----------------------------X---SS-SSSSSSS-----!--S----S-!S-S-S-gSS--------------------------XSSS------SS--o-SX--SSXXX--
----------------------------------------------------------X---S--S-S-SS------S!--S---S--S--S-SSSS------------T----------SSS-SSS---X#-SS#--!St--SS-----
-------------S----------------------S-----------------X---X--SS--S-S-SS----------S---------S-SSSS-----g------T----S-SS-SS---SSSS--X#-S-#---StXXXX-----
----------g---------S---------------------------------X---X--S---S-SSS-----------S--------SS-SSSXXXXXXXXXXXXXXXX----S---S---SSSS-TX#-S-#----tXXXX---S-
----------#-----------------------------------------------X--S---S--S--------g--SS----g---SS-SXXXXXXXXXXXXXXXXXX-k--S---S--SXSSS-TX#-S-#ko--X----S-SSS
----------#----------------------!--------C------------------S--S-#-S---XXXXXXXXXXXXXXXXX-SXXXXX-------------------SS--S----XS-S-TXXXXXXXXXXX----S--SS
-------------------------------------t---o-------------------S--S-#-S---XXXXXXXXXXXXXXXXX-SXXX-------------------S-----S-------S-TXXXXXXXXXX-----S--SS
-----yy------------------------------t-----------------------S-#S##S---------------------XX----------------------------S----S--S-TX----------SSSSS--S-
XXXXXXXXXXX--------------------------t-----------------------S-####S---------------------XX------SSSSSS---SSSS--S%-----SoS-o--XXXXX----------SSSSS--X-
XXXXXXXXXXX-----g-------------------yt---------------------X-SS####S#-------------------------SS-SS--S--------------S---S-----XXXXX---------SSSSS--SS-
