----------------------------------------------------------------------------------------------------
----------------------------------------------------------------------------------------------------
----------------------------------------------------------------------------------------------------
----------------------------------------------------------------------------------------------------
----------------------------------------------------------------------------------------------------
-----------------------------------------------------------------------------------------kk---------
---------------------LSSS---------------------!!!----------------------------------------##---------
----------------------------------------------------------------------------------------###---------
-----------------g---------------------------------------------------------------------####---------
-----------------#----------k----------k--------k--------------------------------------####---------
--------SUS-----##---2-----#-----------TT-----@!!---------!!!!-----S---o---g##-------######---------
---------------###---------#-------k---TT----------------------------------###-----k#######---------
--------------####---------##----------TT--------------B------------------####-----########---------
--M----------#####----kk---r#---yg-----TT--------------b-r----------k--T-k#####---t########--------#
XXXXXXXXXXXXXXXXXXXXXXXXXXXXXXXXXXXXXXXXXXXXXXXXXXXXXXXXXXXXXXXXXXXXXXXXXXXXXXXXXXXXXXXXXXXXXXXkXXXX
XXXXXXXXXXXXXXXXXXXXXXXXXkXXXXXXXXXXXXXXXXXXXXXXXXXXXXXXXXXXXXXXXXXXXXXXX-XXXXXXXXXXXXXXXXXXXXXXXXXX
