------------------------------------------------------
------------------------------------------------------
------------------------------------------------------
------------------------------------------------------
------------------------------------------------------
------------------------------------------------------
------------------------------------------###---------
------------------------------------------###---------
-----------------g---------------------y--###---------
-----------------#---------------------#--###---------
--------SUS-----##--------------------##--###---------
---------------###------------------y###--###---------
--------------####------------------####--###--------F
--M----------#####-----------------#####--###--------#
XXXXXXXXXXXXXXXXXXXXXXXXXXXXXX---XXXXXXX--XXXXXXXXXXXX
XXXXXXXXXXXXXXXXXXXXXXXXXXXXXX---XXXXXXX--XXXXXXXXXXXX
