----------------------------------------------------------------------------------------------------------------------------------------------------------------------------------------------------------------------------------------------------------------------------------
----------------------------------------------------------------------------------------------------------------------------------------------------------------------------------------------------------------------------------------------------------------------------------
----------------------------------------------------------------------------------------------------------------------------------------------------------------------------------------------------------------------------------------------------------------------------------
----------------------------------------------------------------------------------------------------------------------------------------------------------------------------------------------------------------------------------------------------------------------------------
----------------------------------------------------------------------------------------------------------------------------------------------------------------------------------------------------------------------------------------------------------------------------------
-----------------------------------------------------------------------------------------------------------------------------------------------------------------------------------------------------------------------------------------------------------------------##---------
-----------------------------US---------------------------------------------------------------------------------------------------------------------------------------------------------------------------------------------------------------------------------------###---------
---------------------------------------------------------------------------------------------------------------------------------------------------------------------------------------------------------------------------------------------------------------------####---------
-------------------------------------------------------------------------------------------------------#------------------------------------------------------------------@-----------------------------------------------------------------------------------------#####---------
-----------------------------------------------------------------y------------------------------------##--oo------o----o---------------------oooooo-----------------------------------------------oooo-------------------------------------------------------------######---------
---------!!-----------------####--SSC------------------ooo-------##--#-------------------------------###-------------------------------------------------------------------------------ooo----------------------------------------------------TT------------------#######---------
-----------------------y-#####----------------------------------###--##-----------------------------####--------------------------------------------------------K------------------------------------------------B----------------------------TT--------TT-------########--------F
--------------------y-######-----------------------------------####--###---------------------------#####----------------------#---#---------------------------------------#--------------------------------------b-----TT----K----TT----------TT-----r--TT----g-#########--------#
--M----------------#######------------------y-y---------------#####--####------ggg-----ggg------gg######--k-------------------#-k-#---------TT-----##----gg-----------#---#-------k-kkk----kk----------kkk-------b-----TT---------TT--------XXXXXXXXXXXXXXXXXXXXXXXXXXXXXXXXXXXXXX
XXXXXXXXXXXXX--XXXXXXXXX------XX--XXXXXXXXXXXXXXXX--XXXXXXXXXXXXXXX--XXXXXXXXXXXXXXXXXXXXXXXXXXXXXXXXXXXXXXXXXXX---XX---XXXXXXXXXXXXXXXX----TT------XXXXXXXXXXXXXXXXXXX---X--XXXXXXXXXXXXXXXXXXXXXXXXXXXXXXXXXXXXXXXXXXXXXXXXX-XXXXX-X------XXXXXXXXXXXXXXXXXXXXXXXXXXXXXXXXXXXXXX
XXXXXXXXXXXXX--XXXXXXXXX------XX--XXXXXXXXXXXXXXXX--XXXXXXXXXXXXXXX--XXXXXXXXXXXXXXXXXXXXXXXXXXXXXXXXXXXXXXXXXXX---XX---XXXXXXXXXXXXXXXX----TT------XXXXXXXXXXXXXXXXXXX---X--XXXXXXXXXXXXXXXXXXXXXXXXXXXXXXXXXXXXXXXXXXXXXXXXX-XXXXX-X--------------------------------------------
