-------------------------------------------------------------------------------------------------------------------------------------------------------------------------------------------
-------------------------------------------------------------------------------------------------------------------------------------------------------------------------------------------
-------------------------------------------------------------------------------------------------------------------------------------------------------------------------------------------
-------------------------------------------------------------------------------------------------------------------------------------------------------------------------------------------
-------------------------------------------------------------------------------------------------------------------------------------------------------------------------------------------
--------------------------------------------------------------------------------------------------------------------------------------------K----------------------------------------------
---------------------LSSS---------------------------------------------------------------------------------------------------------------SSSSSS----1-----------------------------##---------
--------------------------------------------------------------------------------------------------------------------------------------------------------------------------------##---------
-----------------g-------------------------@-------------------------------------------------------------------------B----------------------------------------------------------##---------
-----------------#-------------------------------------------------------------------------------------g#------------b-------------------K-------------------------------K---#--##---------
---------US-----##---2-----#---!---------------------SC------------------------------------------------##-----------U#CS---------------SSSSSSS------------------------------##--##---------
---------------###---------#-----------------------------------------------------------------TT------g###----B-------------------TT---------------TT-----------------------###--##---------
--------------####---------##--------------#----------K--B------B-----TT----K----TT----------TT------####----b---------K-B-------TT---------------TT---------B------------####------------F
--M----------#####----kk---##----g-----#---#-------k-k---b------b-----TT---------TT----------TT-----#####-y--B-----------b-------TT---------------TT---------b----TT-----#####------------#
XXXXXXXXXXXXXXXXXXXXXXXXXXXXXXXXXXXXXXXX---X--XXXXXXXXXXXXXXXXXXXXXXXXXXXXXXX-XXXXX-X------XXXXXXXXXXXXXXXXXXXXXXXXXXXXXXXXXXX--XXXXXXXXXXXXXXXXXXXXXXXXXXXXXXXXXXXXXXXXXXXXXXXXXXXXXXXXXXX
XXXXXXXXXXXXXXXXXXXXXXXXXXXXXXXXXXXXXXXX---X--XXXXXXXXXXXXXXXXXXXXXXXXXXXXXXX-XXXXX-X------XXXXXXXXXXXXXXXXXXXXXXXXXXXXXXXXXXXX-XXXXXXXXXXXXXXXXXXXXXXXXXXXXXXXXXXXXXXXXXXXXXXXXXXXXXXXXXXX
