---------------------------------XXXXXXXXXXXXXXXXXXXXXX----XXXXXXX-X--r--rr-r---------------------------------------------------##----------TT--------------------######------------------TT------####------------------B-----rXX----TT----r----r-----------------#--------#g###------S-------------@---------#####--#---KXX-----r------------------Xr-----------------rr-r------r---------------r--------------
-----------------------------------------------------------------------XXXXXXXX------r---------------------------------r--------###---------TT-----r-------------#######------------------TT-----#####-----------r-----XXXXXXXXXXX---TT--------------X-------r----##------######---------------K--------------#####--#r--XX--------------r----------------------------kS----------!SSS----------rr--------------
-----------------------------------------------------------------------XXXXXXXX-X-XXXXXXX--XXXXX--r--TT-----*---------------ggg-####----rr--TT-------r----------########---rr----ggrr--g--TT----#####r---------------r-XXXXXXXX--Xr--TT----r----XXXXXXXX-XXX-XXX--##-r--gXXX####-------------------K------r---##XXX--XXXXX---------------------------r------r-------SSS---------------r------------r------------
-------------------------------------------------------------------------r------X-XXXXXXX--XXXXX-----TT---XXXXXXXXXXXXXXrXXXXXX-XXXXXXXXXXXXXXXXXXXXXXXXggg-r--#########XXXXXXXXXXXXXXXXXXXX---XXXXXXX-----------r-XXXX-------------XXXXXXXXXXX-XXXXX-XX-XXX-XXX--XXXXXXXXXXXX##X----rg-------------rrrr------XXXXX--XXXX-------r--r--------------------r----------r-------------------------#------------------
----------------------TT------------------------------------------r--r----------------------------X--TTr--XXXXXXXXXXXXXXXXXXXXX-XXXXXXXXXXXXXXXXXXXXXXXXXXXXXXXXXXXXXXXXXXXXXXXXXXXXXXXXXXXX---XXXXXXX----X----XXXXXXXX-r------r----XXXXXXXXXXX-------------------XXXXXXX---XXXXX---XXXXXXXXXX-XX-X-XXXXXXX---XX----------r-------------r---------------------------------------------------##------------------
----------------------TT----------------------------------r-------------------------------------r-XXXXXX------------------------------------------------XXXXXXXXXXXXXXXX----------------------------------X----XXXX----r-----------------------------r------------------------XX----XXXXXXXXXX-XX-X-XXXXXXX-----------------r-----------------------------r--------------------------------###-----S------------
----------r------2----##----------------------------r------------r---------------------------------XXXXX--------------------------------------------------------------------------------------------------------------------------------------------------------------------------------------------------------r-----------r----r--------------------------------------------------------####------------r--X--
-------------r----------------------------------rrSSS-----r--------r--------------------------------------r----------------------------------r---------------------------------------------------------------------r--------------------------------------------r---r------------------------------------------------------r----#---r-------------------------------------T--------------#####----K-------rrXX--
-----------------------------------------------------S----------------r---------------------------------------------------------------------------------r--------------------------------------------------------------------------------------------r--r-------r------------r---r---------------------------------------r------#------------------------------TT-------r-T---r--g----#-XXXXXX---r----XXXXXXX---
----------r-------2------------oo------------r--------------------------------S-------------------------------r-------------------------------------r-------------------r--------------------------------------------------------r-------------r--r---r--r---------------r--------------------r------------r-------r------------#----K---------------@---------TT------XXXX--XXXXX----XXXXXXXXr---XX--XXXXXX----
--------S@S-------------------r-----------------------------------------------------------r--------------------r---K--------------------r------------------------------------------------------------------------------r-----------------------r--S-S---------------------------r--r--------------------------r---r-------------#------------------------------TTr--XXXXXXX--XXXXX----XX---------XXX---------r--
----r----------------------------------------------2----------------K------------------------------------rr-----CCSSSSSr--------r------rS----------r-----r------------r-------------r-----------------------------------------------------------SS-S-rS-------------------------------------r--------------r----------------------------r--r------------------XXXXXXXXX--------------------------X--r----------r
-----------rr----------------------------------------------------------------S----------------------------r-------------S------------------rr--------r------------------#-------------r------------------------------------------------------------------------------------------------------------------2---------------------X-XXX-XXXX-----##-#-----------XXXXXXX-------------------------------------r------
--M------r------r----------------#-------r--r--r-------rr-------------------------------------------------------------------------------------------S-----------------###------------------r----------#--------------------------------------------r-r--------------r----------------------r------------------------------------XXXX-XXXX-----XXXXr--#krr-XXXX----------------------------------------r--------r
XXXXXXXXXXXXXXXXXXXX--------------#----gg---rrrr-g----rr-----r---------------------K---r-------oo--@----------Sr-------r---------------------------------------------####----------------------------##------------------B-------K------------------SS----------------------r--------------r-------------------r--##----------X-X-------------XXXX---#XXX-XXX-----------------r-------r-r--------------r----r---
XXXXXXXXXXXXXXXXXXXX--------------XXXXXXXXXXXXXXXXXXXXXX----XXXXXXX-X------r---r---r-------------------------S-SSSSSSSSS----------#------r---TT---------------------#####------------------TTr---#--###--oo---oo---------b-----------------------KK---r--------------------------------rUSSS--------------2----#-###--------X-X-------------------r--XXXX-----r---------------------------------------r---------
