---------------------------------------------------------------------------------------------------------------------------------------------------------------------------------------------------------------------------------------------------
---------------------------------------------------------------------------------------------------------------------------------------------------------------------------------------------------------------------------------------------------
---------------------------------------------------------------------------------------------------------------------------------------------------------------------------------------------------------------------------------------------------
---------------------------------------------------------------------------------------------------------------------------------------------------------------------------------------------------------------------------------------------------
----------------------------------------------------------------------------------------------------------------------------------------------------------------------------------------------------------------------------------------XX---------
----------------------------------------------------------------------------------------------------------------------------------------------------------------------------------------------------------------------------------------XX---------
---------------------LSSS----------------------------------------------------------------------!!!!!-----------USSS--------SSCSS------SSSS-----------------------------USSS-----------------------------------SSSSS---@-------------C---XX---------
----------------------------------------------------------------------------------------------------------------------------------------------------------------------------------------------------------------------------------------XX---------
-----------------g----------------------------------------------------------------------------------------------------------------------------------------------------------------------------------------------------------------------XX---------
-----------------#-----------------------------tt------------------------------------------------k-----------------------------------------------g--------------------------TT----------------------------------------------------------XX---------
--------SUS-----##---2-----#---------------TT--tt----------------------------------------------@!!!!----------S-----TT---!!!!--!!!---------------TT-----------------TT------TT-----------------------------C--------!--------------SS---XX---------
---------------###---------#-----------TT--TT--tt------------------------------------TT-----------------------------TT---------------------------TT----------g------TT--tt--TT----------------------#---------------------TT------------XX---------
--------------####---------#-----------TT--TT--tt-------B-----TT----K----TT----------TT-------K---------------------TT---------------------------TT----------TT-----TT--tt--TT------------------K---#---------------------TT------------XX--------F
--M----------#####----kk---###----ggg--TT--TT--tt-------b-----TT---------TT----------TT---g-----------gg----k-ggg---TT------------ggg------------TT----------TT--g--TT--tt--TT-----k----------------#-----gg-------K-K----TT--------k---XX--------X
XXXXXXXXXXXXXXXXXXXXXXXXXXXXXXXXXXXXX-XX--XX--XXXXXXXXXXXXXXXXXXXXXXX-XXXXX-X------XXXXXXXXXXXXXXXXXXXXXXXXXXXXXXXXXXXXXXXXXXXXXXXXXXX----XXXXXXXXXX---XXXXXXXXXXXXXXXXXXXXXXXXXXXXXX---XXXXXXXXXX--XXXXXXXXXXXXXXXXXXXXXXXXXXXXXXXXXXXXXXXXXXXXXXX
XXXXXXXXXXXXXXXXXXXXXXXXXXXXXXXXXXXXX-XX--XX--XXXXXXXXXXXXXXXXXXXXXXX-XXXXX-X------XXXXXXXXXXXXXXXXXXXXXXXXXXXXXXXXXXXXXXXXXXXXXXXXXXX----XXXXXXXXXX---XXXXXXXXXXXXXXXXXXXXXXXXXXXXXX---XXXXXXXXXX--XXXXXXXXXXXXXXXXXXXXXXXXXXXXXXXXXXXXXXXXXXXXXXX
