-------------------------------------------------------------------------------------------------------------------------------------------------------------------------------------------------------------------------------------------------------------------------------------------------------------------------------------------------------------------------------------------------------------------------------------------------------------------------------------------
-------------------------------------------------------------------------------------------------------------------------------------------------------------------------------------------------------------------------------------------------------------------------------------------------------------------------------------------------------------------------------------------------------------------------------------------------------------------------------------------
-------------------------------------------------------------------------------------------------------------------------------------------------------------------------------------------------------------------------------------------------------------------------------------------------------------------------------------------------------------------------------------------------------------------------------------------------------------------------------------------
--------------------------------------------------------------------------------------------------------------------------------------------------------------------------------------------------------------------------------------------------------------------------------------------------------------------------------------------------------------------------------------------------------------------------------------------------------------U----------------------------
-------------------------------------------------------------------------------------------------------------------------------------------------------------------------------------------------------------------------------------------------------------------------------------------------------------------------------------------------------------------------------------------------------------------------------------------------------------------------------------------
--------------------------------------------------------------g----------------------------------------------------k----------------------------------------------------------------------------------------------------g----------------------------------------------------------g-----------------------------------------------------------------------------------------oo-------------------------------------------------------------------------------------------------k----------
------------------SCS-----------------------------------------SSSSS-----SSSSS---------------------------------S---SSSSSSSSS------------US---SS-------------SSS----------------------------------------------------------SSSSS-----SSSSS--------------------------------------------SSSSS-----SSSSS--------------------------SSSSCSSS----------------------------------------SSS--------------------------------------------------------------SSSSS------------------------------##---------
---------------------------TT-----------------------------------------------------------------------------TT------------------------------------------------------TT--------------------------------------------------------------------------------------------------------------------------------------------------------------------------------------------------------------------------------------------------------------------------------------------SS-------------###---------
---------------------------TT----------------------------TT-----------------------TT----------------------TT------------------------------------------------------TT-----------------------------------------------TT-----------------------TT--------------------------------TT-----------------------TT--------------------------------------------------##--------------------------------------------------------------------------------------------------------#--------####---------
---------------------------XX----------------------TT----TT-----------------------TT----------------------TT-------------------------SS---------------------------TT-----------------------------------------TT----TT-----------------------TT--------------------------TT----TT-----------------------TT-------------------------------------------------###------------------SSS-----------------------------------------B------------------K-------------SS------##-------#####---------
-----SSS------TT---2---TT----------------TT---SU---TT----XX------------------2----TT-------------tt------SXXS------------------------------SSS---------#---SSS----XX-----TT-------TT------------tt------SU---TT----XX------------------2----TT-------------tt------SU---TT----XX------------------2----TT------------------#----2----##----------------#--###-------@@@@@-D----------------------------S@---------SS------S#2----------------SSSSS-----------------###------######---------
--------------TT-------TT-------------K--TT--------TT----------------------TT-----TT-----TT------tt-----------------------------------------------#-TT-#-----------------TT-----TTTT----TT------tt-----------TT----------------------TT-----TT-----TT------tt-----------TT----------------------TT-----TT-----TT-----------#------K--##------TT------g##--###----------------------------------K-B-------------------------------B--------------K---#----B--------####-----#######---------
--------------TT-------TT-----TTTT-------TT--------TT---------TT-----tt----TT--TT-TT-----TT------tt-TT--------TT--------------TT--TT-------------##-TT-##----------------TT---TTTTTT----TT------tt-TT--------TT---------TT-----tt----TT--TT-TT-----TT------tt-TT--------TT---------TT-----tt----TT--TT-TT-----TT-----------#---------###-----TT------###--###------------------------------------bK----------B-------------------b-----TT-----------#----b-------#####----########--------F
--M-----------TT----k--TT-----TTTT-------TT------k-TT---------TT-----tt----TT--TT-TT---k-TT------tt-TT--------TT--------------TT--TT------------###-TT-##---------k------TT---TTTTTT----TT------tt-TT------k-TT---------TT-----tt----TT--TT-TT---k-TT------tt-TT------k-TT---------TT-----tt----TT--TT-TT---k-TT------ggg--#---------###-----TT---g-####--###-----------K------oo----------------B-----------b--y------B--y-y----b-----TT-----------#----B------######---#########--------#
XXXXXXXXXXXXXXXXXXXXXXXXXXXXXXXXXXXXXXXXXXXXXXXXXXXXXXXXXXXXXXXXXXXXXXXXXXXXXXXXXXXXXXXXXXXXXXXXXXXXXXXXXXXXXXXXXXXXXX------XXXXXXXXXXXX-X-XXXXXXXX-XXXXXXXXXXXXXXXXXXXXXXXXXXXXXXXXXXXXXXXXXXXXXXXXXXXXXXXXXXXXXXXXXXXXXXXXXXXXXXXXXXXXXXXXXXXXXXXXXXXXXXXXXXXXXXXXXXXXXXXXXXXXXXXXXXXXXXXXXXXXXXXXXXXXXXXXXXXXXXXXXXXXXXXXXXXXXXXXXXXXXXXXXXXXXXXXXXXX--XXXXXXXXXXXXXXXXXXXXXXXX----XXXXXXXXXXXXXXXXXXXXXXXXXXXXXXXXXXXXXXXXXXXXXXXXXXXXXXXXXXXXXXXXXXXXXXXXX-XXXXXXXXXXXXXXXXXXXXXXXXXXX
XXXXXXXXXXXXXXXXXXXXXXXXXXXXXXXXXXXXXXXXXXXXXXXXXXXXXXXXXXXXXXXXXXXXXXXXXXXXXXXXXXXXXXXXXXXXXXXXXXXXXXXXXXXXXXXXXXXXXX------XXXXXXXXXXXX-X-XXXXXXXX-XXXXXXXXXXXXXXXXXXXXXXXXXXXXXXXXXXXXXXXXXXXXXXXXXXXXXXXXXXXXXXXXXXXXXXXXXXXXXXXXXXXXXXXXXXXXXXXXXXXXXXXXXXXXXXXXXXXXXXXXXXXXXXXXXXXXXXXXXXXXXXXXXXXXXXXXXXXXXXXXXXXXXXXXXXXXXXXXXXXXXXXXXXXXXXXXXXXX--XXXXXXXXXXXXXXXXXXXXXXXX----XXXXXXXXXXXXXXXXXXXXXXXXXXXXXXXXXXXXXXXXXXXXXXXXXXXXXXXXXXXXXXXXXXXXXXXXX-XXXXXXXXXXXXXXXXXXXXXXXXXXX
