---------TT-------------!---------------------------------------T----S-------------------XX#---XXX-X--X---T---------------S-------------------S--#---#
--------#TT----S--X--------S----T-----S----------------X--tt----T----S--S--------------XXXXXXX-XXXXX------X-!----S-S----2--------S-S------------S#S--#
--------XXT-------XX------------T-------X--------------XX-tt---XX----------------S---XyXX--XXX----X------SXST-------------S---------------X------#---#
--------XXTk-------XX-----------T-----S-X---------------XXtXXXXXX-------S-------S----XX-------X-------------T-------X----#----------------X------#---#
---------SXX--------XXX-B---XXX-XX-------X-----S---------XXXXXX--S--S-----------------X-------X-----!------XT-------X--S-#-------S---------------Xk-##
----------XXK---S----XXXb--yXXXXXXXXXX-F-XX-----------k---X---------S-S---------T----------------------S---XX-S--XXX-XXXXXg--------------X-------XX-##
------------X#-T-------XX--#---X--XXXX-#--XX-------XX-X--------------S----#S----T--XX-----------------------X----XXX-XXXXXX---------k---XX------#-XX##
------------XX-TT-------XXXX----------XX---X-XX-C-yXXXX------------S------#-----X--XX----------------2-------X------------XX---X---XXXX-X-------X--X##
-------------XXXT--------XXX----------XXS--SXXX--XX--X-------S---#--S-----#-----XXX--S-------------------S---X--X----------X-kkXXXXXXXXX----ySXXX---##
--------------XXX-----------------------S---X----XX----------S---#----XT--#-----XXX-----------------@---------X-X-----------XXX-XXX----X----XXXXSS--##
----------S-----X--------------------S---------X-----------------##---XT--#--X-XX-----------------------------XX-S-------S--XXX---------S---XX---S--XX
-----------------o-----------------------------XX-------------S--##--X-X--#XXXXX-------------------------------X---------SS----------------------S-SXX
----------------------------------S-------------X-S--------------#XXXX-XXXXXX-X----------------T----------#------------------------------S----S-------
----XX--------------------------------------------S------------S-#XXX---XXX--------------------TB----X----X-------!------o----------------------------
XXXXXXX--------C-S--------S--S----------o---------S-----------S--#----------S------------------Sb----XX-XXX--------------S---------------------S------
XXXX--X----T--------------------------------------S------------S-T----S----------S-------------ST-----XXXX-B-----------------------------------S------
