-------#---#-X---X------------@-------#-----XX--------X-----------------X#-----------------#--##---X----#---------------gX-------X----------X-X-X--t--
-------X---#-X----------g------X------#-----XX--------------------------XX----#------------#-XX#S---X---XX-------------XX-------tX-----------XX----t--
-------Xg--#X---t-------#------X------X----------------X-----------------X--X-X------X----t#-XX#----X---XX------X-----XXX-------t----------t-X----Xt--
--------g--#X--Xt-------X-------------X----------------X-------------@t-----X-X------X----tX---#-S--------------X----tX-----F---t---X-----Xt------Xt--
--------X--#---Xt--#----------g---S----XX-----------------------------t-------------------tX---#----------S----#-----t-----XX---t---X----XXt-------t--
--------X--#----X--#-X---XX---X-X---XX-XX----------S--------#---------t---S#--------------t----#---------------#-X---t-----X----t--------X-t-------X--
-----------#----X--#-XX-XXX---X-X#--XX---------gX----------tX---------tX---#-------------------#---------------#-X-X-X-------XXtX----------X-------X--
-----------#------X#--XXX--------#-g-----------XX----------XX-------X-tX---#--------------X----#------X--------#--XX-X-------XXtX--#-X-----X----------
------X--X--------XX---X---XX----#-X-------!---X-X---------X-X------X-X-!--X---g-------g--X----#------X-------XX--X-r--------------#-XX---------------
------X--X-X-------X-------XXg---#-X-------------X---X---X---X-------XX----#-------------------#-----------X--XX----X----------X---#--XX--------------
-----#----XX-----------------X---#----------------X--X---X------X----X----------#--------------#-------X---Xt-------X----------X---#---X--------------
-----#----X------------------X---X-------XX-------XXX---------XXX--#-------X----#X-----t-------##--t---X----t-------g--------------X------------------
----kX--------tr-----------------X-------XX-X------XX-----X---XX-XX#------#X----XXXX---tFt-----##--X--------XX---------------------X----#--SX--------t
----XX--------t----------------------------XX#------------X------XXX------#-S---X-XXXX--#t-----##X-X--------XX--------------------------#---S---X-X--X
XXXXX---------tX-----------------------#---X-#--------X------------X------#---X-----XX-XXX-----##X--------------------------------------XX---g--X-X--X
XXXX----#---#-tX--X--------------------#-----#--------XX------------------#---X--------XXX-----##---X----#----------------X-------------XX---X---X--#-
