--------X--X-S----X------------X------SS--------SX------X-#X--------S-S-------X----------S---X------------X---X--S-X-----!X-------S---------X------STg
----S-S----S------X----X-------XX---o----o-X----XX------X-SS---S--X-SS--------X---X----o----SX--X----------S-SX-----X----SXS----#-----X--g--X---SS-SXX
------T------SS--------XX--o----X--------X-X----S------S----------X----S---------gX-------S----SX-------------X-----X#-------S--X-S---S--S---o------XX
S-----#-----------------X---X---X--------X---X-SS-oSX------oSo-XX-----T--S-----TSX--X-U-XS----X-------------X#-------X----------S-S-------T---------XX
S---S-X----S---X-S----------X----S-------S---X-----SX--X---g---XXX-S-XSX-S---S--S#--X-----X!-SX----------#--XX-----S--X-S-S----X----------X-----------
S-----XSS-SS---S------S-----X--S-------X----------S--------S-S-XX--X---X-S--oS--S---X--------S-----------X---X--------XgS-S#---X--S-S-----T-S---X-----
S-----X---SS----------------X--------S-XS-------S-S--X----o----XX-SXS--------!------X--S-#-kX----S----XY-X-S----X----------X-X--X---S--X-S------XS----
S-----S-S-S--------o------X----S--C---------------S-SX--o-S-S-X----XSSS-------X-S-S----X--oXX--S------X-------S-X----------#----XX-S--XXS--SS-SXX----S
S-------------g--X--------X--X-----------S--S----------------SX----ST-X--X----XS---#S--XX--X------S------------SX----S--#S-------X-S----X----S-X------
S-----XX--gS--X#-X-------SS----------SX--X------S-S----------S--S---X-X---X---XX---X---XXX-X--g-------------XSS-------SSXS-----X---S-X--XS-------X----
S-----XX--XX--X-X-S------X----------S-T--X--------X----X-S----S-S-T-SSX---T---SX-X-X----T-----#-X------SX--------X--XXS-S-----S------XS--S-------XS---
S--------#XX-------------S---XX---S----S-X--------X----X-S----S---XS--X--------X-#--------------S------S#-X------XX--X--#--#--------------S-------o---
S----X--oSX-T---------#---S---#---S----------X-X-------T-------S---------------S-----------------X----S--XX--#---XX--------X---------!----------S-S--S
S----X--X-S-----SS----X------o---------S----SX-XS-------X----XS------S-S--XS---S-X--k----SS-----------S--XX--X----X---S-------S-S-S------X------X--XSS
XXXX-o--X-S--X--X----SX-S-S------------SST--X-----X-----X---S------S-S----X------X--X!----------S---S-S-------------So--------S----S--k--X------X--X--
XXXX-o---X--#-S-X--T--X---------X-S-----S---X-----X----SXX-X#----------S-------T-XS-----------X-S-----S----g--#-----X------X------S------X-SSS------T-
