------------------------------------------------------------------------------------------------------------------------------------------------------
----------------------------------------------S-------------------------------------------------------------------------------------------------------
------------------------------------------------------------------------------------------------------------------------------------------------------
------------------------------------------------------------------------------------------------------------------------------------------------------
-------------------------------------------S----------------------------S------------------------------------------------------------1--------------XX
--------!---!S!--S!SS-!-SSSSSS!-!------------SS-S-S-S-!S-!S--SS--S-!---S-----SS-!------!S-SS-S-!S-----S!-S-SS!S-S-S---!!-S!S--!---S--S-----SSS----S-XX
------------------------------------g-!--S----------------------------------------------------------------------------------------------------S-------
------------------------------------------------------------------------------------------------------------------------------------------------------
---------------------------!--------------------------------------------------------------------------------------------------------------------------
-!-S!1S---S-!-!-SS!!!!S!-S--!-S!!!!S-!SSU!S---SSS--!!-@!!-!!-S!--1S--@S-!---!@SS-S!-!S-SS!S@-S-!!--St#S--S!!!1S-SS!-!-t--SCC!-SSS--!!S!!SSC!-S---S@---
-------S---------------------S----------------S------#--------------------------t---U---------------t#------S------t--t--------------------S----#-----
---------------------------t-------------------------#--------------------------t-------------t-----t#-------#-----t--t#-----------t------------#-----
--#---------g--------------t-------#-----------S-----#-------------------------St-------!-----t-S---t#-------#-----t-Ct#-----------t----------g-#--#--
--XXXXXXX-XXXXXX-XXXXXXXXXXXXX-X-XXXXXXXX-XXXX-XXXXXXXXXXXXX-XXXXXX-XXX-XXXXXX-XXXXX-XXXXXXXXXX-XXXXXXXX-XXXXX-XXXXX-XXXXXXXXXXXXXXX-XXXXXX-XXX-X--XX-
X-XXXXXXX-XXXXXX-XXXXXXXXXXXXX-X-XXXXXXXX-XXXX-XXXXXXXXXXXXX-XXXXXX-XXX-XXXXXX-XXXXX-XXXXXXXXXX-XXXXXXXX-XXXXX-XXXXX-XXXXXXXXXXXXXXX-XXXXXX-XXt-X--XX-
X-----------------------------------------------------------------------------------------------------------------------------------------------------
