------S-----SX---S----SS---S--X---S-X-SX-#--------SS----------SX--X----S---S-X-X-#------S--S-S-------X--S----S-X--SXS--X--------------g-SX------------
------S---S-X-S-S-----S-o--SS-------XS---X-!--X-X---------So--S---XX---S----SX---X--------S----X--X-------S-------SS---#--------------X------------X--
-----S--X------G--g-o-Sg---------------Xo--X--XXX-----------XS----XX-------------XT-----X---SgS---X-----S-SX------S------o-------X----X------S---X----
S---SS-S-------#--X--S-X---S------X--X-#---SS--S--XS--S---SS-------X---S--g-------X-----X-XX-X---------SX--X----X---S-S----------X-------S-------X--S-
S---X---g----#-X---r--------------XS--------X----SS----X---X-----------X----S-----X-------X--S---S---S--XS-----SS--------X--S--------S-------SSX-----#
S---X---S------XX-------X-----S---XXSX--S---XS-----S---X-S-------------X------X---------------X-XS---S------S-----S------X------X----#---------X-----S
S------S-------XX-------X----------XSX-------S----------------------o-SX----X------S-#--------X-S-----XS-----S-----X--#--XS-----X-X--#S--------X------
S---------SS--S----S-k----------X--X---T-----------g----X-X---g---SS--S-X---X--S-----X------X--------------S-------XX-SS-X---2----X--X--------S-------
S---------X--T-------------------X--S--XS-------X-S-----S-X-------X-----XX-------o--SXS---STX----X-----------g------#--------#-------XS--SX--X------X-
S---------X--R-----X--------S----X---------#X-S-X-----SS--XS---#--X--X-S-X---X----US------TXXo---X-S-----------SS-X-#---X-----X-------S---X--X----X-X-
S------X--------------------S#--S-------SX-XX-S-X----!-------X-X-----X-X---#-U---XSS--TX--SX-----X---------X--------S---X--SX-X----o----------X---X-S-
S-----!X----!-------T--#S---XX-------------XX---#----S------SXX-S---------SX-----XSS--XX---X-----X---oT#-XS#SS---gX---------g-------S---X---S-XS--X---
S------S--------------X-----XXS-o------X--X----X#-------S--SSST--X----SS--S-------X-S-XS----o-S----SS-SX-#SX---X-XX-S----X--X--X--------X--XS-X-----S-
S-----------S---X-----X---X--------------------#T---!--#--SXS----S-------------S--X--S---------------X-----XS--X----S--X-S-----X--------S-----X-SX----
XXXX---S--------XS----X---X-S--------S--oX----------X--#XX---S----S--------S----------S-S---------X-oX--------SX-----X-X#SSg--------------SX----SXS-S-
XXXX---S-----S--------XS-SS----#---S-S--S-CS-----------X-X---S--X----S-X----S---X-----SS---SS-X---X---X-----S-T-X--U-#--XSS-S-------S-----X----g-X----
