--------X-------------------S---#--T--X-----X---@----XX---X---#---#-------k#X-XXXX-------C----------#--------#----T---#X-----------#---X--------------
--------------------------#-----#--TXXX-----X---#-#-XX----X---#---#T------X#X-XX--------------------X--------#---TT---#-----X------#------------------
--------------------------#-----X--XXX----------#-X-X----X----X---#T---k-kXXXX-------#--------------X--------#---TT---#----XX------#----------------#-
--------------------------#-----X-XXS-----------X-X------#----X-r-#T--XXXX-XXX-------#-------------X---------#---TTX--F----X------##----------------#-
--------------------------#-------X-----------XXX--------#-----XXX#T-XXXXX-----------#---------#-XXX---------#---TXXk------X------##--X----#--------X-
--------------------------#---XX-------------XXX--------##-X---XXX#TXX--------------##-----------XX----------#---XX-XXXXX-XX------##-kX----#--------X-
--------------------------#--yXX%------------X--------S-##XXXXX---XXX---------o-----##-----------------------XX--X--XXXXXXX-------##-X-----#----------
-----------------------------X--|------X----X-----------#tX-XXX---XX----------------##--------------SX-----XXXXXX--------X---X----#XXX-%---X---------#
-------------K---------------X--|------XX--XX-----------#X-------------------S-----o##----------o----X-----XX--XX------------X----XXX--|---X-----k---X
-------------#------S-----X-X-----------X-XX------------#X--------------------------##-XX-------X---------XX-----------o---------XX---S|---------X---X
-------------t------------XXX----#-------XX--------#----X-------------------#---X---#TXXXX---XXXX--------XXX-------------------XXX--o--|--------XX-X--
-------------T-----k----XX-X-----#-------X---------#----XXC-----------------#---X--TXXX--X--XXXXC------XXX---------------------XX----S----------X-XXX-
-------------XXX-XXX-k-XXX-------#------X----------#-----X----------C-------#------XXX-----XX---------XXX-----------------------------------XXX-X-X-X-
-------X-----XXX-XXXXXXX---------#--T---X--S-------#-o---X-----#---#-----S--#------X------XX----------X-----------------S-----------------XXXXXXX-----
XXXXXXXX-kXXXX------XXX----------#--T--------------X%----X-----#---#------X-#-X-----------X----------------------------#-----------------XXX---X------
XXXXXXX--XXXXX-------------------#--T--------------X---X-------#---#------X-#-X--XX------------------#-----------------#X-----------F---XX------------
