---------X----------------X-X-----SX---X-X---
----------X-X-----X--#X----|-X-S----S-XXS-X--
----X--X|--X--------X--XS--------|-------X--F
----------#-----XX---#-T----X--XX--X-X---XT--
-------------S--X-----------------X-X--X-----
-------#X-X-X-#-X-X---------X----|--S-X----X-
-------XS-------#|--------#-------#-|--X----#
---------XX----X--XX---X--|----#---------X--T
----X--------------X--------X---%X-X-X---X--X
--------T------|----X---|-X---X#--------T-%--
----------------------------X--------X-S-----
-------X-----X-XX--------------------%-S---#-
----X----Xg----X----------XX----X--------|---
--M--XXT-XXX---X---|X-----T-----X--|------X--
XXXX-S!-X--XX--%----X-SX-----o--X----XX------
XXXX---X----------XX---XT------X---|-XX---X--
