-------------------------------------------------------------------------------------------------------------------------------------------------------------------------------------------------------------
-------------------------------------------------------------------------------------------------------------------------------------------------------------------------------------------------------------
-------------------------------------------------------------------------------------------------------------------------------------------------------------------------------------------------------------
-------------------------------------------------------------------------------------------------------------------------------------------------------------------------------------------------------------
-------------------------------------------------------------------------------------------------------------------------------------------------------------------------------------------------------------
--------------------------------------------------------------g----------------------------------------------------------------------------------------------------------------------------------------------
------------------SCS-----------------------------------------SSSSS-----SSSSS--------------------------------------------------------------------------------------------------------------------g##---------
---------------------------TT---------------------------------------------------------------------------------------@----------------@----------------------------------------------------------g###---------
---------------------------TT----------------------------TT-----------------------TT---------------------------------------------------------------------------------T-------------------------g####---------
---------------------------XX----------------------TT----TT-----------------------TT---------------------------------------------------------------------------------T------------K------------#####---------
-----SSS------TT---2---TT----------------TT---SU---TT----XX------------------2----TT---------------------------ooo--------------------------------------------------##-------------###-----#--######---------
--------------TT-------TT-------------K--TT--------TT----------------------TT-----TT-----TT-------------------------#----------------C--------------K--------------#-------------------------#######---------
--------------TT-------TT-----TTTT-------TT--------TT---------TT-----tt----TT--TT-TT-----TT-------------------------#--------------#---#--------------B------------#------------------------########--------F
--M-----------TT----k--TT-----TTTT-------TT------k-TT---------TT-----tt----TT--TT-TT---k-TT----gg---------kkk-------#-----k----ggg-#--k#--------------b-ggg-------#----------gg------------#########--------#
XXXXXXXXXXXXXXXXXXXXXXXXXXXXXXXXXXXXXXXXXXXXXXXXXXXXXXXXXXXXXXXXXXXXXXXXXXXXXXXXXXXXXXXXXXXXXXXXTTXXXXTTXXXXXXXXXXXXXXXXXXXXXXXXXXXXXXXX--XXXXXXXXXXXXXXXXXXXXXXXXXXXXXXXXXXXXXXXX--------XXXXXXXXXXXXXXXXXXX
XXXXXXXXXXXXXXXXXXXXXXXXXXXXXXXXXXXXXXXXXXXXXXXXXXXXXXXXXXXXXXXXXXXXXXXXXXXXXXXXXXXXXXXXXXXXXXXXTTXXXXTTXXXXXXXXXXXXXXXXXXXXXXXXXXXXXXXX--XXXXXXXXXXXXXXXXXXXXXXXXXXXXXXXXXXXXXXXX--------XXXXXXXXXXXXXXXXXXX
