-------------------------------------------------------------
-------------------------------------------------------------
-------------------------------------------------------------
-------------------------------------------------S-----------
-------------------------------------------------------------
-------------------------------------------------------------
------------------SCS-----------------------------##---------
---------------------------TT--------------------###---------
---------------------------TT-------------------####---------
---------------------------XX-------------------####---------
-----SSS------TT---2---TT---------------------#-####---------
--------------TT-------TT-------------K------##-####---------
--------------TT-------TT-----TTTT-------tt-###-####--------F
--M-----------TT----k--TT-----TTTT-------tt####-####--------#
XXXXXXXXXXXXXXXXXXXXXXXXXXXXXXXXXXXXXXXXXXXXXXXXXXXXXXXXXXXXX
XXXXXXXXXXXXXXXXXXXXXXXXXXXXXXXXXXXXXXXXXXXXXXXXXXXXXXXXXXXXX
