---------------------------------------------------------
---------------------------------------------------------
---------------------------------------------------------
---------------------------------------------------------
---------------------------------------------------------
---------------------------------------------------------
---------------------LSSS---------------------##---------
---------------------------------------------###---------
-----------------g--------------------------####---------
-----------------#-------------------------#####---------
--------SUS-----##---2-----#--------------######---------
---------------###---------#-------------#######---------
--------------####---------##--------tt-########--------F
--M----------#####----kk---##---gg---tt#########--------#
XXXXXXXXXXXXXXXXXXXXXXXXXXXXXXXXXXXXXXXXXXXXXXXXXXXXXXXXX
XXXXXXXXXXXXXXXXXXXXXXXXXXXXXXXXXXXXXXXXXXXXXXXXXXXXXXXXX
