-------!----------X----
---------1-------------
-----------b----------F
----k------------------
-------X--X------------
-----------------------
-----------------------
------r----------------
------k--------b---%X--
--------------y--------
-----------------------
--------------X-S------
-----------------------
--M--------------------
XXXX-----G-----------G-
XXXX-----X-----X-----y-
