-------------------1--------b--S------
-----------------------b--------------
-----X-----------K-----------------X--
----------X---------------------------
--------------------------------------
-------------bB-----------------------
--------------------------------X-----
--------------------------------------
--------------------------------------
---------------------b---X------------
-------X-------------------------S----
-------B-----------------X------------
-----o---------G----------------------
--M------------------L----------------
XXXX--------------------------------XF
XXXX----------------------------------
