--------------------
--------------------
--------------------
--------------------
--------------------
--------------------
--------------------
--------------------
--------------------
--------------------
--------SUS---------
--------------------
-------------------F
--M----------------#
XXXXXXXXXXXXXXXXXXXX
XXXXXXXXXXXXXXXXXXXX
