------------------------------------------------------------------------------------------------------------------------------------------------------------------------------------------------------------------------------------
------------------------------------------------------------------------------------------------------------------------------------------------------------------------------------------------------------------------------------
------------------------------------------------------------------------------------------------------------------------------------------------------------------------------------------------------------------------------------
------------------K-----------------------------------------------------------------------------------------------------------------------------------------------------------------------------------------------------------------
------------------------------------------------------------------------------------------------------------------------------------------------------------------------------------------------------------------------------------
--------------------------------g---------------------------------------------------------------------------------------------------------------------------------------------------------------------------------------------------
-------------------##---------SSSSSSSS-----------------------------------------------------------------------------------------------------------------------------------------------------------------------------------##---------
------------------###------------------------------------------------------------------------------------@--------------------------------------------------------------------------------------------------------------###---------
-----------------####--------g-----------------------------------------------------------------------------------------------------------------------------------------------------------------------------------------####---------
-----------------####---------------------------------------------------------------------------------------------------------------------------------k---------------------------------------------------------------#####---------
-----SSS-------#-####------S@S-------------------------------!!!!-----------------------------------ooo-----------------------------------------------TT-------------------------------------------------------------######---------
--------------##-####--------------------TT-----------------------K-------TT-----------------------------#--------------------------------------------TT------------------------TT----------------------------------#######---------
-------------###-####--------------------TT-------------------------------TT-------------C@--------------#--------------------------------------------TT------------------------TT---------B------------B----------########--------F
--M---------####-####--------------------TT----gg-----------------------kkTT---------------------k-------#----y-yyyy------------------------kkk-------TT-------------ggg--------TT---------b--yy--------b-g---ggg-#########--------#
XXXXXXXXXXXXXXXXXXXXXXXXXXXXXXXXXXXX---XXXXXXXXXTT---XXXXXXXXXXXXXXXXXXXXXXXXXXXXXXXXXXXXXXXXXXXXXXXXXXXXXXXXXXXXXXXXXXXXXX----XXXXXXXXXXXXXXXXXXXXXXXXXXXXXXXXXXXXXXXXXXXXXXXXXXXXXXXXXXXXXXXXXXXXXXXXXXXXXXXXXXXXXXXXXXXXXXXXXXXXX
XXXXXXXXXXXXXXXXXXXXXXXXXXXXXXXXXXXX---XXXXXXXXXTT---XXXXXXXXXXXXXXXXXXXXXXXXXXXXXXXXXXXXXXXXXXXXXXXXXXXXXXXXXXXXXXXXXXXXXX----XXXXXXXXXXXXXXXXXXXXXXXXXXXXXXXXXXXXXXXXXXXXXXXXXXXXXXXXXXXXXXXXXXXXXXXXXXXXXXXXXXXXXXXXXXXXXXXXXXXXX
