--------------------------------------------------------------------------------------------------------------------------------------------------------------------------------------------------------------------------------------------------------------
--------------------------------------------------------------------------------------------------------------------------------------------------------------------------------------------------------------------------------------------------------------
--------------------------------------------------------------------------------------------------------------------------------------------------------------------------------------------------------------------------------------------------------------
--------------------------------------------------------------------------------------------------------------------------------------------------------------------------------------------------------------------------------------------------------------
--------------------------------------------------------------------------------------------------------------------------------------------------------------------------------------------------------------------------------------------------------------
-------------------------------------------------------------------------g----------------------------------------------------------------oo--------------------------------------------------------------------------------------------------------k---------
--------------------------SSSSS---------------------@-----------@------SSSSSSS---------------------US---SS-------------SSS----------------------------------------SS!SSS@SSS--------SSC--------------------------------USSS------------------------##---------
-----------------------------------------------------------------------------------------TT-----------------------------------TT-------------------------------------------------------------oooo----------oooo-----------------------------------###---------
------------------------------------TT--------------------------------g------------------TT-----------------------------------TT----------------------------------------------------------------------------------------------------------------k####---------
------------------------------------TT---------o-----------------------------------------XX------SS---------------------------TT-----------------------o------------K---------------SSS---------------------------------------------------------#####---------
-----SSS-----------------------2----TT-----TT-------!--!-----S------S@S--------------TT----------------SSS---------#---SSS----XX-----TT-------------------TT------SSSSSSSSSSS---------------------------TT------------S-----TT-----------------######---------
---------------tt------------TT-----TT-----TT----------------------------------------TT-----------------------#-TT-#-----------------TT-------------------TT-------------------------------#------------TT------------------TT----------------#######---------
---------------tt------tt----TT--TT-TT-----TT---------------------------------#------TT-----TTTT-------------##-TT-##----------------TT---------tt--------TT-------------------------------#------------TT------------------TT---------------########--------F
--M------------tt-g----tt----TT--TT-TT-----TT---------------------------------#-g-g--TT-----TTTT------------###-TT-##---------k------TT---ggg---tt-k------TT--------------K----------------#---------y--TT----------k-ggg---TT--------------#########--------#
XXXXXXXXXXXXXXXXXXXXXXXXXXXXXXXXXXXXXXXXXXXXXXXXXXXXXXXXXXXXXXXXXXXXXXXXXXXXXXXXXXXXXXXXXXXXXXXXXXXX-X-XXXXXXXX-XXXXXXXXXXXXXXXXXXXXXXXXXXXXXXXXXXXXXXXXXXXXXXXXXXXXXXXXXXXXXXXXXXX----XXXXXXXXXXXXXXXXXXXXXXXXXXXXXXXXXXXXXXXXXXXX---XXXXXXXXXXXXXXXXXXXXXXXX
XXXXXXXXXXXXXXXXXXXXXXXXXXXXXXXXXXXXXXXXXXXXXXXXXXXXXXXXXXXXXXXXXXXXXXXXXXXXXXXXXXXXXXXXXXXXXXXXXXXX-X-XXXXXXXX-XXXXXXXXXXXXXXXXXXXXXXXXXXXXXXXXXXXXXXXXXXXXXXXXXXXXXXXXXXXXXXXXXXX----XXXXXXXXXXXXXXXXXXXXXXXXXXXXXXXXXXXXXXXXXXXX---XXXXXXXXXXXXXXXXXXXXXXXX
