-----||-------------------------------------|||-----------------------||--------------||||||||||||||----------------|--|||---|||----------------------
-----||-------------------------------------------------------------------------------|||-----|||||--------------------||-----------------------------
----------------------------------------------------------------------------------------------||||-------------------------------------------%------%-
-------------------o----------------------------------------------o----------------------------------------------------------------------------------%
------------------------------------------------------------------%o---------------o-----------------------------@----------------------------%------|
----------------------------------------------------------------%g|%----------------SS--o--------------------------o-----------------r---------------|
----------------------o-------------------------o----------------%||--------------------%--o-----------------------%-----------------%---------o-----|
------------------------------------%----------------------------|||----------------------%%--------------------%-%---------------------------%------|
---------------------------------------------------------R-%-----|%|%-----------------%---|----------------------%|--------------o-%-----%----|%%%---|
-------------------------------%%--------------------------------|||----------------------|--%%------------------||----%-------------------r--|||----|
-------------------------%------|%---%%--------------------------|||--%--%%%-----------%--|---|------------------|%----------%------%%%---%%%%|||----|
--------------------------------||%%-||%-------o-----------------|||---%%|||%----------|--|---|---------%%%%-%%%-||-----------%-----|||%--|||-|||-----
------------------%%%%%---%%%---|||--||--------r------------%%%%-||%---||||||%%--------|%%|---|-----%%-%|||---||%||-----%%%%%-|%----||||%%||----------
%%%%---------------||--%%-||----|||--||-----%%%%%-----------|||--|||---|||||-|---------||||---|%%%%%|---||-------||-%-r-||||--||%%%-|||||-||----------
-||--%%%%--------------|--||----|||--||------|||----------%%|||--------||||------------||||---|||||||---||-------||%%%%-||||--||||--|||||-------------
-||---||------------------||---------||------|||------------|||--------|||-------------|||%%%%%||||||------------|||||--||||--||||--|||||-------------
