------------------------------------------------------------------------------------------------------------------------------------------------------
------------------------------------------------------------------------------------------------------------------------------------------------------
-------------------------------------------------------S--------------!!-------S-SSSS-----------------------------------------------------------------
-----------------------------------------------------------------------------------------------------------------------#-------------S----------------
--------------------------------------------------------------------------------------------------------------------k###--S---------------------------
----------------------------S---------------------------S----------------------------------------------------------#####---------#----------S---T-#---
--------------------------US-----------------------------------------!S2-----------------------------------#-#---#######-------###-------------TT##---
-----------------------------------------------##------------------------TT------t-------------------------#-#--########-#-----#-#--------S!---TT##---
-------------------------------#-----------t--###------------------------TT----TTtt------------------------#-###########-#--K--#-#-------------TT##---
-------------------------------#----------St-####-------------K--gk----ggTT----TTtt--------k-----------k---#-###########-#-----#-#-------------TT##---
----TT--------------------!S---#----------StF####-----XXXXXXXXXXXXXXXXXXXXXXXXXXXXXXXXXXX-XXXXXXXXXXXXXXXXXXXXXXXXXXXXXXXXXXXXXXXX------k--g-g-TT-#---
----TT-------------------------#----------St#####-----XXXXXXXXXXXXXXXXXXXXXXXXXXXXXXXXXXX-XXXXXXXXXXXXXXXXXXXXXXXXXXXXXXXXXXXXXXXX-----XXXXXXXXXXXX---
----TT-------------------------XXXXXXXXXXXXXXXXXX--------------------------------------------------------------------------------------XXXXXXXXXXXX---
----TT---g---y---------g-------XXXXXXXXXXXXXXXXXX----------------------------------------------------------------------------------------------------X
XXXXXXXXXXXXXXXXXXXXXXXXXXXX-------------------------------------------------------------------------------------------------------------------------X
XXXXXXXXXXXXXXXXXXXXXXXXXXXX-----------------------------------------------------SS-------------------------------------------------------------------
