--------------------------------------------------------------------------------------------------XXXXXXXXXXXXXXXXX--XXXXXXXXXXXXXXXX-----#-----------
------------------------------------------------------------------------------------------------------------------------------------------#-----------
------------------------------------------------------------------------------------------------------------------------------------------#-----------
---------------------------------------------------------------------------------------------K--------------------------------------------#-----------
-----------------------------------------------------------------------------------------------------------------------------------------XX-----------
--------------------------------------------------------------------------------------------k-#------------------------------------------XX-TT--------
-----------SSS-----------------SSSSS-------------------------------------------1----------2-#-#---------------------------------------------TT--g-----
----------------------------------------------------------------------------o---------------#-#--------------------------------------------XXXXXXXXXXX
----------------------------------------------------T---------------------------------------#-#--S-----------------#-----------------------XXXXXXXXXXX
--------------U-------------------------------------T----T----------------------------------#-#-----------------y###-------------------SSS------------
-------------------TT---------SSSSStS!!-------------X----TT-----------!------------------SSS###---------------######----------------------------------
-------------------TT--------------t---------------------TTTT---T---------------------------#-#------------#########----------------------------------
-------------------TT--------------t---------------------TTTT--TT-KK------------------------#--------tt----#########------------T---------------------
----------gg-------TT-------------kt--g---k-----k-----gk-TTTT--TT---g--g-------g------gk--k-#--------tt----#########-----------TT--K------------------
XXXXXXXXX-XXXXXXXXXXXXXXXXXXXXXXXXXXXXXXXXXXXXXXXXXXXXXXXXXXXXXXXXXXXXXXXXXXXXXXXXXXXXXXXXXXX-------ktt----#########----g--k--gTT----------#----------
XXXXXXXXX-XXXXXXXXXXXXXXXXXXXXXXXXXXXXXXXXXXXXXXXXXXXXXXXXXXXXXXXXXXXXXXXXXXXXXXXXXXXXXXXXXXX------XXXXXXXXXXXXXXXXX--XXXXXXXXXXXXXXXX-----#----------
