-------------------------------------------------------------------------XXXXXXXXXXXXXXXXX------------------------------------------------------------
-------------------------------------------------------------------------------------------------------------------------------------------S----------
------------------------------------------------------------------------------------------------------------------------------------------S-----------
-------------------------------------------------------------------------------------------------------------------------------------SSS--------------
-------------------------------------------------------------------------------------------------------------------------------------S---S--SSS------!
-----------------------------------SS------------------------------------------------------------------------------------------------S----------------
-----------------------------------------------------------------------------------------------------------------------------------USS--!-------------
---------------------------------------------------------------------------------------------------------------------------------o---S----------------
-----------------------------------------------------------------------------------------------------------------------------------------------------!
----------------------------------SSS---------------------------------------------------------------------------------------------------g-------------
---------------------------------------------------------tt--------------------------------------TT------------------------------------##-------------
---------------------------------------------------------tt-----------------C!SS!---------##-----TT-----------------------------------##-----------kk-
---------g---------g#----------gM-kk--rg-----------g---ggtt--------------------------TT--##------TT---------------------------------g###----XXXXX-XXXX
---------XXXX-XXXXXXXXXXXXXXXXXXXXXXXXXXXXXXXXXXXXXXXXXXXXXXXXXXXXXXXXXX-------------TT--##------TT--------g--------k--k------------####----XXXXX-XXXX
XXXXXXX--XXXX-XXXXXXXXXXXXXXXXXXXXXXXXXXXXXXXXXXXXXXXXXXXXXXXXXXXXXXXXXX--g--k-------TT--##-#-XXXXXXXXXXXXXXXXXXXXXXXXXXXXXXXXXXX-XXXXXX--------------
XXXXXXX-------------------------------------------------------------------XXXXXXXXXXXXXXXXX---XXXXXXXXXXXXXXXXXXXXXXXXXXXXXXXXXXX-XXXXXX--------------
