-------------------------------------------------------XXXXX---|------%%%---||||||------------||-|%-|||||---------------------------------------------
-------------------------------------------------------XXXXX----------||----|||||-------------||---%%||||----------------ooo-----o-------------o------
---------------------------------------------------------------------------------------------------||||||----------------%%%-----SS---S---------------
------------------------------------------------------------------------------------S-----o----------||||-----------------||-------------------%------
-------------------------------------------------------------------------------------S-----------------------------S------||%------------------------S
-----------------------------------------------------------------%o-------------------S-----------------------------------||--------------------------
------------------------------------------------------------------%o------------------------------------------------------||-%---------------%--------
------------------------------------------------------------------|%--------S----------------o--%----------%%%%%----------||------------------%-%-----
-----------------------------------------------------k----!-------||-------------------------------------g-|||||---%------||------------------|%|%----
------------------------------------------------------------------||-----------------------------%-------%-|||||oo--%%%-%-||------------%-----|||-----
-------------------------------oTT-------------!S!----------------||%---------------------%%%-%----------|-|||||-r--||---%%%%%%%%--------%%%--|||--R--
---------------B----tt--------K-TT---K-------------------S--#-----||---------------------%||------%-%%-%%|-%%%%%%%%-||---|||-|||---------||---|||-----
---------------b----tt----------TT-------------------------##-----||----------------------||---%%%|%-|%|||-|||||||--||-------||----------||---|||-----
-----kk-------gB---gtt----------TT------g---g--------------##-----||----------------------||---||-|--|||||-|||||||--||-------||----------||----||-----
XXXXXXXXXXXXXXXXXXXXXXXXXXXXXXXXXXXXXXXXXXXXXXXXXXXXXXX----##--%%%%%--------%%%%%%%%------||---||-|--|||||-|||||||------------------------------------
XXXXXXXXXXXXXXXXXXXXXXXXXXXXXXXXXXXXXXXXXXXXXXXXXXXXXXX----##---||||---------||||||-------||---||-|--|||||--------------------------------------------
