----------------------XXXXXX--------------------------------------------------------------------------------------------------------------------------
------------------------------------------------------------------------------------------------------------------------------------------------------
------------------------------------------------------------------------------------------------------------------------------------------------------
------------------------------------------------------------------------------------------------------------------------------------------------------
------------------------------------------------------------------------------------------------------------------------------------------------------
------------------------------------------------k----------------------------------------------------------------kS!------------------!SSS-----SS-----
-----------------SS-----------U-----------------SCS--------------------------------------------------------------S--------------------------o---------
-----------------------------------------------T-----------------------------------o------------------------------------------------------------------
------------------------o----------------------T--------------2--------------------------------------------------1------------------------------------
-----------------------------------------------S-g----------------------------------------------------------------S!------TT----------2-------!@S----T
------SS--------S------------------------------SSSS-------------------TT-TT-----------------------------------------------TT-------------------------T
----------------------------TTT---------------------------------------TT-TT-----------------------------------------------TT----#--------------------T
----------------------------TTT--------------------------------F------TT-TT----------------------K------------------ggg--yTT--g--------M-------------T
-----k------gg--k-k---------TTT--------------K----g------------#------TT-TT---k---------------g------g---k------XXXXXXXXXXXXXXXXXXXXXXXXXXXXXXXXXXXX-X
XXXXXXXXX--XXXXXXXXX--------TTXXXXXXXXXXXXXXXXXXXXXXXXXXXXXXXXXXXXXXXXXXXXXXXXXXXXXXXXXXXXXXXXXXXXXXXXXXXXXXX---XXXXXXXXXXXXXXXXXXXXXXXXXXXXXXXXXXXX-X
XXXXXXXXX--XXXXXXXXX---XXXXXXXXXXXXXXXXXXXXXXXXXXXXXXXXXXXXXXXXXXXXXXXXXXXXXXXXXXXXXXXXXXXXXXXXXXXXXXXXXXXXXX-----------------------------------------
