--------------------------------------------------------------------------------------------------------------------------###-####-#------------------
--------------------------------------------------------------------------------------------------------------------------###-######------------------
------------------------------------------------------------------------------------------------------------------------------######-g--k--------g----
------------------------------------------------------------------------------------------------------------------------------XXXXXXXXXXXXXXXXXXXXXXXX
------------------------------------------------------------------------------------------------------------------------------XXXXXXXXXXXXXXXXXXXXXXXX
------------------------------------------------------------------------------------------------------------------------------------------------------
-----------------------------------------------------S-------------------------------USSSSSS-S@-------------------------------------------------------
------------------------------------------------------------------------------------------------------------------------------------------------------
-------------------------------------------------------------------------------------------S----------------------------------------------------------
------------------------------------------------------------------------------------------------------------------------------------------------------
-------------------------C!----!-------------------TT-----------------------------------------------------------#-------------------------------------
---------------------------------------------------TTTT---------------------------------------------------------##-###g-------------------------------
----------tt-----------------F--------------F------TTTT---------------K-tt---------------------------------F----#######-------------------------------
---------ktt------gk---g---k-#--g-------k---#-k----TTTT---k---k---g--M--tt--------g---k-----------k--------#----####---#------------------------------
XXXXXXXXXXXXXXXXXXXXXXXXXXXXXXXXXXXXXXXXXXXXXXXXXXXXXXXXXXXXXXXXXXXXXXXXXXXXX-XXXXXXXXXXXXXXXXXXXXXXXXXXXXXXXXXXXXXX----#g---------------S------------
XXXXXXXXXXXXXXXXXXXXXXXXXXXXXXXXXXXXXXXXXXXXXXXXXXXXXXXXXXXXXXXXXXXXXXXXXXXXX-XXXXXXXXXXXXXXXXXXXXXXXXXXXXXXXXXXXXXX-----#####------------------------
