------------------------------------------------------------------------------------------------------------------------------------------------------
------------------------------------------------------------------------------------------------------------------------------------------------------
------------------------------------------------------------------------------------------------------------------------------------------------------
------------------------------------------------------------------------------------------------------------------------------------------------------
----------------------------------------------------------------------------------------------------------------------------------o-------------------
------------------------------------------------------------------------------------------------------------------------------------------------------
--------SSS---------------------------------------------------------------C---------------------------------t-----------------------o-----------------
-------------------------------------------------------------S---------------------------------------------tt----------TT-----------------------------
--------------------------------------------------------------------------------------------T--------------tt--------TTTT-------TT--------------------
-------!---o--------------------SU---------------------------------------S------------------T--------------tt--------TTTT-------TT---X--------ttt-X---
-------------------------------------T---------------------TT-------------------------------TTTT-----t----Ttt--------TTTT----k--TT---X-------gttt-X---
------------------------------------TT---------------------TT--------tt---------------------TTTT-----t----TtXXXXX-XXXXXXXXXXXXXXXXXXXXXXXXXXXXXXXXXXXX
-------------F----------------------TT-----tttt------------TT-----K--tt---------------------TTTT-----t----TtXXXXX-XXXXXXXXXXXXXXXXXXXXXXXXXXXXXXXXXXXX
----ggMK-----#--k---g----------g----TT--g-gtttt------------TT--------tt----gg----g-g--------TTTT-----tg--kTX------------------------------------------
XXXXXXXXXXXXXXXXXXXXXXXXXXXXXXXXXXXXXXXXXXXXXXXXXXXXXXXXXXXXXXXXXXXXXXXXXXXXXXXXXXXXXXXXXXXXXXXXXXXXXXXXXXXX------------------------------------------
XXXXXXXXXXXXXXXXXXXXXXXXXXXXXXXXXXXXXXXXXXXXXXXXXXXXXXXXXXXXXXXXXXXXXXXXXXXXXXXXXXXXXXXXXXXXXXXXXXXXXXXXXXXX------------------------------------------
