------------------------------------------------------------------------------------------------------------------------------------------------------
------------------------------------------------------------------------------------------------------------------------------------------------------
------------------------------------------------------------------------------------------------------------------------------------------------------
---------------------------------------------------------------------------------------------------------------------------SSSSSSSSSSSSSSSSSSSSSSSSSSS
------------------------------------------------------------------------------------------------------------------------------SSSSSSSSSSSSSSSSSSSSSSSS
---------------------------------------------------------------------------------------------k--------------------------------SSSSSSSSSSSSSSSSSSSSSSSS
--------SS----------------------------------------------------------------------------------S!S--S!S------------SUS------S----SSSSSSSSSSSSSSSSSSSSSSSS
-------S--------------------y-------------------------------------------------------------------------------------------------------------------------
-------S------------------#SS--o--------------------------------------------------g#------------------------------------------------------------------
------SS-----------------##------------------------------SSUSSS------------------g##--------------------------------------S---------------------------
----SS--SS--------------###--SC--------------------------------------------------###--------S!S--S@S-----------#####------------SSSSSS@-SSSSSSSSSSSSSS
--------------#-TT-----####-----------------K-----------------------------------####---------------------------#----------------SSSSS---SSSSSSSSSSSSSS
-------------##-TT----#####---SSS---------------K------------------------------#####--------------------------K#----------------SSSSS---SSSSSSSSSSSSSS
-------r----###-TT---######---------------------------------------------------######------k------ggg-----------#---------------------oooSSSSSSSSSSSSSS
XXXXXXXXXXXXXXX-XXXXXXXXXXX------XXXXXXXXX-X-XX-X-XX-XXXXXXXXXXXXXXX-X-X-XXXXXXXXXXX--XXXXXXXXXXXXXXXXXXXXXXXXXXXX----XXXXXX---XXXXXXXXXXXXXXXXXXXXXXX
XXXXXXXXXXXXXXX-XXXXXXXXXXX------XXXXXXXXX-X-XX-X-XX-XXXXXXXXXXXXXXX-X-X-XXXXXXXXXXX--XXXXXXXXXXXXXXXXXXXXXXXXXXXX----XXXXXX---XXXXXXXXXXXXXXXXXXXXXXX
