------------------------------------------------------------------------------------------------------------------------------------------------------
------------------------------------------------------------------------------------------------------------------------------------------------------
------------------------------------------------------------------------------------------------------------------------------------------------------
------------------------------------------------------------------------------------------------------------------------------------------------------
------------------------------------------------------------------------------------------------------------------------------------------------------
------------------------------------------------------------------------------------------------------------------------------------------------------
--------------!-----------------------------------------1---------------------------------------------------------------------------2-----------------
--------------------------------------------------o----------------------------oo---------------------------------------------------------------------
------------------------------------------------------------------------------------------------------------------------------------------------------
------------------------------------------------------------------------y------------------o-----------------o--------------K---#---------------------
--------------@----------------------------------o-o--!!!!--------------##-------------TT----------------TT--------------------##---2----------TT-----
----------TT-----------------------------------------------------------###--TT---------TT----------------TT-------------------###--------------TT-----
----------TT----------------------------------------------------------####--TT---------TT----------------TT------------------####--------------TT-----
----------TT--------------------y-y-----y---------y----yy------------#####--TT---------TT-------------y--TT-----------------#####----y---kkk---TT-----
XXXXXXXXXXXXXXXXXXXXX--XXXXXXXXXXXXXXX-XXXXXXXXXXXXXXXXXXXXXXXXXXXXXXXXXXX--XXXXXXXXXXXXXXXXXXXXX---XXXXXXXXXXXXXXX--XXXXXXXXXXXXXXXXXXXXXXXXXXXXXXXXX
XXXXXXXXXXXXXXXXXXXXX--XXXXXXXXXXXXXXX-XXXXXXXXXXXXXXXXXXXXXXXXXXXXXXXXXXX--XXXXXXXXXXXXXXXXXXXXX---XXXXXXXXXXXXXXX--XXXXXXXXXXXXXXXXXXXXXXXXXXXXXXXXX
