--------------------------------------------------------------------------------------------------------------------------||--------|||||--||-||||||||
------------------------------------------------------------------------------------------------------------------------------------|||||--||-||||||||
------------------------------------------------------------------------------------------------------------------------------------------------------
------------------------------oo----------------------------------------------------------------------------------------------------------------------
-----------------------------------g-g----------------------------------------------------------------------------------------------------------------
--------------------ooor---------%%%%%%%-------------oooo----------R------------------oo--oo----------------------------------------------------------
-------------------%%%%%----------|||||--------------%%%%----------------g----oo----------------------------------------------------o------------@----
--------------------|||-----------|||||----oo---------||-------------%%%%%%------------------------r-----------SSS------R-----oo----------------------
--------------------|||-----------|||||---------------||--------------||||-----------------------%%%%%%%%---------------------SS----------------------
--------------------|||-----%%%%%-|||||---------SSS---||--------------||||-----SSS----------------||||||-----------------------------o----ooo------r--
-----------------%%%%%%%%----|||--|||||---------------||-------%%%----||||-------------SS---------||||||---------------------------------------%%%%%%-
------------------||||||-----|||--|||||-------------U-||--------|-----||||------------------------||||||-------------------------SS-------------||||--
------------------||||||--o--|||--|||||---------------||--------|-----||||-----------------%%%%---||||||-----------------------------------%%%%-||||oo
-----------%%%%---||||||-%%%-|||--|||||---------------||--------|-----||||------------------||----||||||------------------------------------||--||||--
XXXXXXXXX---||----||||||--|--|||--|||||----%%%%-----%%%%%-%%%%%-|-----||||------------------||----||||||--%%%%%%----%%%%--------------------||%%%%%%%%
XXXXXXXXX---||----||||||--|--|||--|||||-----||-------|||---|||--|-----||||------------------||----||||||---||||------||---%%%%------%%%%%%%-||-|||||||
