--------------------------------------------------XX--XXXXXXXXX--XXXXXXXXXXXXXXXXXXXXXXXXXXXXXXXXXXXXXXX--XXXXXXXXXXXXXXXXXXXXXXX---XXX-XX-XX-XXXXXXXX
------------------------------------------------------------------------------------------------------------------------------------------------------
------------------------------------------------------------------------------------------------------------------------------------------------------
------------------------------------------------------------------------------------------------------------------------------------------------------
------------------------------------------------------------------------------------------------------------------------------------------------------
------------------------------------------------------------------------------------------------------------------------------------------------------
----------------!-------------------------------------------------------------------------------------------------------------------------------------
--------------------------------------------------US----------------------------------------------------!!!!------------------------------------------
--------------------------------------------------------------------------------------------oo--------------------------------------------------------
------------------------------------------------------------------------------------------------------------------------------------------------------
----------------@-----------------------------------------------------------------------------------------y-------------------------------------------
------------TT------------------------------y-#--####--SSS--------------------------------------------!!@SS!!!----------------------------------------
------------TT---------------------------y-########--------TT-----TT----K-----------------#-----------------------------------------------------------
------------TT--------------------y-y---#########----------TT-----TT----------------------#----------------------------TT-----------------------------
XXXXXXXXXXXXXXXXXXXXXXX--XXXXXXXXXXXXXXXXXXXX--------------TT-----TT-----------ggg--------#-------y--------------------TT-----------------------------
XXXXXXXXXXXXXXXXXXXXXXX--XXXXXXXXXXXXXXXXXXXX------XX--XXXXXXXXX--XXXXXXXXXXXXXXXXXXXXXXXXXXXXXXXXXXXXXXX--XXXXXXXXXXXXXXXXXXXXXXX---XXX-XX-XX-XXXXXXX
