------------------------------------------------------------------------------------------------------------------------------------------------------
------------------------------------------------------------------------------------------------------------------------------------------------------
------------------------------------------------------------------------------------------------------------------------------------------------------
------------------------------------------------------------------------------------------------------------------------------------------------------
------------------------------------------------------------------------------------------------------------------------------------------------------
-----------------------------------------------------------------------------------------------------------------k------------------------------------
---------------------------------------------------------!-!-------------------------1-------------------SSSS---S!S--S!S-----------SUS------S---------
--------------------------------------------#---------------------------------------------------------------------------------------------------------
--------------------------------------------#---------------------------------------------------------------------------------------------------------
--------------------------------------------#-------------------------------------------------------------K----------------------------------SU-------
-------!!-----------------------------------##-----------!-!-----------------------!!!!-----------------SSSSS---S!S--S@S----------#####---------------
------------------------------------------y#--------------------------------------------------------------------------------------#----------------K--
----------------------------------------####-------------------------------------------------------------------------------------K#-------------------
------------------------------y-y------#####-----------------y----------------------yy-------------------------------ggg----------#-------------------
XXXXXXXXXXX--XXXXXX--XXXXXXXXXXXXXXX-XXXXXXXXXXXXXXXXXXXXXXXXXXXXXXXXXX----XXXXXXXXXXXXXXXXXXXXX--XXXXXXXXXXXXXXXXXXXXXXXXXXXXXXXXXXX----XXXXXXX--X-XX
XXXXXXXXXXX--XXXXXX--XXXXXXXXXXXXXXX-XXXXXXXXXXXXXXXXXXXXXXXXXXXXXXXXXX----XXXXXXXXXXXXXXXXXXXXX--XXXXXXXXXXXXXXXXXXXXXXXXXXXXXXXXXXX----XXXXXXX--X-XX
