------------------------------------------------------------------------------------------------------------------------------------------------------
------------------------------------------------------------------------------------------------------------------------------------------------------
------------------------------------------------------------------------------------------------------------------------------------------------------
------------------------------------------------------------------------------------------------------------------------------------------------------
------------------------------------------------------------------------------------------------------------------------------------------------------
------------------------------------------------------------------------------------------------------------------------------------------------------
------------------USS-------------------------------------------------------------------------------------------------------------SUS-----------------
------------------------------------------------------------------------------------------------------------------------------------------------------
-------------------------------------------------------B----------------------------------------------------------------------------------------------
-------------------------------------------------------b----------------------------------------------------------------------------------------------
------------------------------!!!!-------------------SS#CS-----------------------------------------------------------------------#####-------------TT-
---------------K---B---------------K-B-----K---B----------------------------------TT---------------------------------------------#-----------------TT-
----------B--------b-------B---------b---------b---------K-B----------------------TT--------------------------------------------K#-----------------TT-
----------b--------B-------b---------b---------B-----------b-------F-----k--------TT------------------------------ggg------------#-----------------TT-
XXXXXXXXXXXXXXXXXXXXXXXXXXXXXXXXXXXXXXXXXXXXXXXXXXXXXXXXXXXXXXXX--XXXXXXXXXXXXXXXXXXXXXXXXXXX---XXX--X-X-X-XXXXXXXXXXXXXXXXXXXXXXXXX----XXXXXXXXXXXXXX
XXXXXXXXXXXXXXXXXXXXXXXXXXXXXXXXXXXXXXXXXXXXXXXXXXXXXXXXXXXXXXXX--XXXXXXXXXXXXXXXXXXXXXXXXXXX---XXX--X-X-X-XXXXXXXXXXXXXXXXXXXXXXXXX----XXXXXXXXXXXXXX
