------------------------------------------------------------------------------------------------------------------------------------------------------
------------------------------------------------------------------------------------------------------------------------------------------------------
------------------------------------------------------------------------------------------------------------------------------------------------------
------------------------------------------------------------------------------------------------------------------------------------------------------
------------------------------------------------------------------------------------------------------------------------------------------------------
-----------------------------------------------------------------------------------------------y------------------------------------------------------
--------------------------------------------------------------!-!------------------------------##-----------------------------------------------------
--------------------------------------------------------------------------------o-o----------y###-----------------------------------------------------
---------------------------------------------------------------------------------------------####----------------------------K------------------------
------------!--!---------------oo----------------------------------------------o-----------y-####---------------------oo------------------------------
-------!!---------------------o--o----------------------------!-!----------------o---------######---C--------------------------#----------------------
------------------------------------------------------------------------------------------#######------------------------------##----------------tt---
-----------------------------------------------------------------------------------------########--------F--------------------####-----tt--------tt---
-------------------------------------------y--------y-------------y----------y--y-------#########--------#-------------------######----tt--------tt-g-
XXXXXXXXXXXXXXXXXXXXX--XXXXXXXXXXXXXXXXXXXXXXXXXXXXXXXXXXXXXXXXXXXXXXXXXXXXXXXXXXXXXXXXXXXXXXXXXXXXXXXXXXXXXXXXXXXXX------XXXX-XXXXXXXXXXXXXXXXXXXXXXX
XXXXXXXXXXXXXXXXXXXXX--XXXXXXXXXXXXXXXXXXXXXXXXXXXXXXXXXXXXXXXXXXXXXXXXXXXXXXXXXXXXXXXXXXXXXXXXXXXXXXXXXXXXXXXXXXXXX------XXXX-XXXXXXXXXXXXXXXXXXXXXXX
