------------------------------------------------------------------------------------------------------------------------------------------------------
------------------------------------------------------------------------------------------------------------------------------------------------------
------------------------------------------------------------------------------------------------------------------------------------------------------
------------------------------------------------------------------------------------------------------------------------------------------------------
------------------------------------------------------------------------------------------------------------------------------------------------------
------------------------------------------------------------------------------------------------------------------------------------------------------
---------------------------------------------------------------!!!!---------------------------------------------------------------#------------------S
------------------oooo------------oooo------------oooo--------------------------------------------------------------------------y##--------------TT---
--------------------------------------------------------------------------------------------------------------------------------###--------------TT---
-----------------------------------------------------------------y-------------------------------------------------------------####--------------TT---
-----------!---TT--------------TT--------------TT------------!!@SS!!!---------------------------------------------------------#####-------------SXXS--
---------------TT--------------TT--------------TT-------------------------------------------------------#--------------------######-------------------
---------------TT--------------TT--------------TT-----------------------------TT------------------------#-------------------#######--------F---------T
---------------TT---y------y---TT---y------y---TT-----------------------------TT------------------------#----y--y----------########--------#---------T
XXXXXXXXXXXX-XXXXXXXXXXXXXXXXXXXXXXXXXXXXXXXXXXXXXXXXXXXXXXXXXXX--XXXXXXXXXXXXXXXXXXXXXXX---XXX--XXXXXXXX--XXXXXXXXXXXXXXXXXXXXXXXXXXXXXXXXXXXXXXXXXXX
XXXXXXXXXXXX-XXXXXXXXXXXXXXXXXXXXXXXXXXXXXXXXXXXXXXXXXXXXXXXXXXX--XXXXXXXXXXXXXXXXXXXXXXX---XXX--XXXXXXXX--XXXXXXXXXXXXXXXXXXXXXXXXXXXXXXXXXXXXXXXXXXX
