------------------------------------------------------------------------------------------------------------------------------------------------------
------------------------------------------------------------------------------------------------------------------------------------------------------
------------------------------------------------------------------------------------------------------------------------------------------------------
------------------------------------------------------------------------------------------------------------------------------------------------------
------------------------------------------------------------------------------------------------------------------------------------------------------
--------------------------------k-------------------k-------------------------------------------------------------------------------------------------
--------------1-----------------##-----------------S!S--S!S-----------------------------------------------------------1-------USS------------------SS!
------------------------------y###--------------------------------------------------------------------------------------------------------------------
------------------------------####------------------------------------------#-------------------------------------------------------------------------
-----------------------------#####------------------------------------k-----#-----------------------------------------ggg----------------------------K
-------------!!!------------######-----------------S!S--S@S--------SCSSS----#-------#------------S--------------##########---#-------------TT------SSS
---------------------------#######-----------------------------------K-----##-------##-------TT----------------##--------#---#-------------TT---------
--------------------------########--------F--------------------------------##-------###------TT--------TT-----###--------#---##------------TT---------
--------------y----------#########--------#------k------ggg--------K---K---##-------###---gggTT------k-TT----####--------#---##--gg----k---TT---------
XXXXXXXXXXXXXXXXXXXXXXXXXXXXXXXXXXXXXXXXXXXXXXXXXXXXXXXXXXXXXXXXXXXXXXXXXXXXX---XXXXXXXXXXXXXXXXXXXXXXXXXXXXXXXXX--------X---XXXXXXXXXXXXXXXXXXXXXXXXX
XXXXXXXXXXXXXXXXXXXXXXXXXXXXXXXXXXXXXXXXXXXXXXXXXXXXXXXXXXXXXXXXXXXXXXXXXXXXX---XXXXXXXXXXXXXXXXXXXXXXXXXXXXXXXXX--------X---XXXXXXXXXXXXXXXXXXXXXXXXX
