----------------------------------------------------------------------------------------------------------------------------------------------------------------------------------------------------------------------------------------------------------
----------------------------------------------------------------------------------------------------------------------------------------------------------------------------------------------------------------------------------------------------------
----------------------------------------------------------------------------------------------------------------------------------------------------------------------------------------------------------------------------------------------------------
---------------------------------------------------------------------------------------------------------X------------------------------------------------------------------------------------------------------------------------------------------------
--------------------------------------------------------------------------------------------------------XX--------------------------------------------K---------------------------------------------------------------------------------------------------
-------------------------------------------------------------------------------------------------------TXX----------------------------------------------------------------k-------------------------------------------------------------------------------
--------------------------------US-----------------------------------------------------y--------------LSXX-----------------------C------SSC-----------##-----------------S!S--S!S----------------------------------------------------------------------##-
-------------------------------------------------------------------------------------#SSS---------------XX-------------------------------------------###----------------------------------------------------------------------------------------------###-
------------------------------------------------------------------------oo----------##------------g-----XX-----------------------------------------g####---------------------------------------------------------------------------------------------####-
--------------------------------------------------------------------y--------------###1-----------#-----XX------------------------------SSS-------g#####------------------------------------k-------------------------------------------------------#####-
------------!!-----------------####--SSC------------------ooo-------##-------------###-----------##---2-XX----------------TT---SUS----------------######-----------------S!S--S@S--------SCSSS------#--#----------##--#------------SS!S------------######-
--------------------------y-#####----------------------------------###-----------#-###--SS------###-----XX-------------K--TT---------------------#######-----------------------------------K-------##--##--------###--##--------------------------#######-
-----------------------y-######-----------------------------------####----------##-###--------#####-----XX--------F-------TT--------------------########--------F---------------------------------###--###------####--###-----tt--------------tt-########-
----------------------#######------------------y-y---------------#####-------------###--------#####----kXX--------X-------TT-------------------#########--------#------k------ggg--------K---K---####--####----#####--####----tt---------gg---tt#########-
XXXXXXXXXXXXXXXX--XXXXXXXXX------XX--XXXXXXXXXXXXXXXX--XXXXXXXXXXXXXXX---XXXXXXXXXXXXXXXX--XXXXXXXXXXXXXXXXXXXXXXXXXXXXXXXXXXXXXXXXXXXX----XXXXXXXXXXXXXXXXXXXXXXXXXXXXXXXXXXXXXXXXXXXXXXXXXXXXXXXXXXXXXXXXXXXXXXXXX--XXXXXXXXXXXXXXXXXXXXXXXXXXXXXXXXXXXX
XXXXXXXXXXXXXXXX--XXXXXXXXX------XX--XXXXXXXXXXXXXXXX--XXXXXXXXXXXXXXX---XXXXXXXXXXXXXXXX--XXXXXXXXXXXXXXXXXXXXXXXXXXXXXXXXXXXXXXXXXXXX----XXXXXXXXXXXXXXXXXXXXXXXXXXXXXXXXXXXXXXXXXXXXXXXXXXXXXXXXXXXXXXXXXXXXXXXXX--XXXXXXXXXXXXXXXXXXXXXXXXXXXXXXXXXXXX
