----------------------------------------------------------------------------------------------------------------------------------------------------------------------------------------------------------------------------------------------------------
----------------------------------------------------------------------------------------------------------------------------------------------------------------------------------------------------------------------------------------------------------
----------------------------------------------------------------------------------------------------------------------------------------------------------------------------------------------------------------------------------------------------------
------------------------------------------------------------------------------------------------------------------------------------------------------------------U---------------------------------------------------------------------------------------
----------------------------------------------------------------------------------------------------------------------------------------------------------------------------------------------------------------------------------------------------------
------------R------------------oo--oo---------------------------------------------------------------------------------------------------------------------------------------------------------------------------------------------------------------------
------------------g----oo---------------------------R-----oo--------------------##----------------------------------##---------------------------SSSSS---------------SS-------------SSS----------------------------C--S!----------------------------------
--------------%%%%%%------------------------r-----------------------------------##---------------------------------###---------------------------------------------------------------------TT-------------------------------------------------------------
---------------||||-----------------------%%%%%%%%-------------------SSS------####--------------------------------####---------------------------------------------------------------------TT---------------------------------------------------B---------
---------------||||-----SS-----------------||||||-----------------------------####-------------------------------#####----------------------------K-------------SS-------------------------TT--------oo-----------------------------------------b---------
--------%%%----||||-------------SS---------||||||-----%%%%--%%%%------------######--------------SS!S------------######---------------------------SSSSS--------------SSS---------#---SSS----XX-----TT------------S@!----C!!!-------------------SS#CSS------
---------|-----||||------------------------||||||------||----||-------------######-----------------------------#######------------------------------K---#----B-------------#-TT-#-----------------TT------------------------K-B-----K---B---------K-------
---------|-----||||-----------------%%%%---||||||------||----||-------------######--------F----------------tt-########--------F------B-----TT-----------#----b------------##-TT-##----------------TT--------------------------b---------b-----------------
%%%%-----|-----||||------------------||----||||||--ooo-||----||---------r---######--------#-----------gg---tt#########--------#------b-----TT-----------#----B-----------###-TT-##---------k------TT-k----y-------------------b---------B-----------------
-||-%%%%-|-----||||------------------||----||||||--%%%-||----||----XXXXXXXXXXXXXXXXXXXXXXXXXXXXXXXXXXXXXXXXXXXXXXXXXXXXXXXXXXXXXXXXXXXXXXXXXXXXXXXXXXXXXXXXXXXXXXXX-XXXXXXXX-XXXXXXXXXXXXXXXXXXXXXXXXXXXXXXXXXXXXXXXXXXXXXXXXXXXXXXXXXXXXXXXXXXXXXXXXXXXXX
-||--||--|-----||||------------------||----||||||---|--||----||----XXXXXXXXXXXXXXXXXXXXXXXXXXXXXXXXXXXXXXXXXXXXXXXXXXXXXXXXXXXXXXXXXXXXXXXXXXXXXXXXXXXXXXXXXXXXXXXX-XXXXXXXX-XXXXXXXXXXXXXXXXXXXXXXXXXXXXXXXXXXXXXXXXXXXXXXXXXXXXXXXXXXXXXXXXXXXXXXXXXXXXX
