----------||||||--ooo-||----||---------r---######--------#------g-g-k-##---ggg--#---------#--------------------------------------------kk#------------
----------||||||--%%%-||----||----XXXXXXXXXXXXXXXXXXXXXXXXXXXXXXXXXXXXXXXXXXXXXXXXXXXXXXXXXXXXXX-X-XX-X-XX-XXXXXXXXXXXXXXXXX-X-X-XXXXXXXXXXXXXXXXXXX--
----------||||||---|--||----||----XXXXXXXXXXXXXXXXXXXXXXXXXXXXXXXXXXXXXXXXXXXXXXXXXXXXXXXXXXXXXX-X-XX-X-XX-XXXXXXXXXXXXXXXXX-X-X-XXXXXXXXXXXXXXXXXXX--
------------------------------------------------------------------------------------------------------------------------------------------------------
------------------------------------------------------------------------------------------------------------------------------------------------------
------------------------------------------------------------------------------------------------------------------------------------------------------
------------------------------------------------------------------------------------------------------------------------------------------------------
------------------------------------------------------------------------------------------------------------------------------------------------------
--------R---------------------------------------------------------------------------------------------------------------------------------------------
--------------------R-----oo--------------------##--------------------------------SSSSCSSS------------------------------------------------------------
----------------r-------------------------------##----------------------------------------------------------------------------------------------------
----------%%%%%%%%-------------------SSS------####----------------------------------------------------------------------------------------------------
-----------||||||-----------------------------####--------------------------------------------------------------SSUSSSSS------------------------------
%%%%-------||||||-----%%%%--%%%%------------######---------------------#---------#----2----#----------------------------------------------------------
-||--------||||||------||----||-------------######---------------------#---------#------K--#-------K--------------------------------------------------
-||--------||||||------||----||-------------######--------F------------##--------#---------#-----------K----------------------------------#-----------
