------------------------------------------------------------------------------------------------------------------------------------------------------
------------------------------------------------------------------------------------------------------------------------------------------------------
------------------------------------------------------------------------------------------------------------------------------------------------------
------------------------------------------------------------------------------------------------------------------------------------------------------
------------------------------------------------------------------------------------------------------------------------------------------------------
-------------------------------------------------------------k----------------------------------------------------------------------------------------
-------------------------------------#------------------S---SSSSSSSSS------------US---SS-------------SSS---------------------------SSS----------------
-----------------------------------y##--------------TT------------------------------------------------------TT----------------------------------------
-----------------------------------###--------------TT------------------------------------------------------TT----------------------------------------
------------------------o---------####--------------TT-------------------------SS---------------------------TT----------------------------------------
-----------!---------------------#####-------------SXXS------------------------------SSS---------#---SSS----XX-----TT-------TT-C---SSS-----#--#-------
--------------------------------######------------------------------------------------------#-TT-#-----------------TT-----TTTT------------##--##------
-------------------------------#######--------F---------TT--------------TT--TT-------------##-TT-##----------------TT---TTTTTT-----------###--###-----
--------------------X---------########--------#---------TT--------------TT--TT------------###-TT-##---------k------TT---TTTTTT----------####--####----
XXXXXXXXXXXXXXXXXXXXXXXXXXXXXXXXXXXXXXXXXXXXXXXXXXXXXXXXXXXXXXXX------XXXXXXXXXXXX-X-XXXXXXXX-XXXXXXXXXXXXXXXXXXXXXXXXXXXXXXXXXXXXXXXXXXXXXXXXXXXXXXXX
XXXXXXXXXXXXXXXXXXXXXXXXXXXXXXXXXXXXXXXXXXXXXXXXXXXXXXXXXXXXXXXX------XXXXXXXXXXXX-X-XXXXXXXX-XXXXXXXXXXXXXXXXXXXXXXXXXXXXXXXXXXXXXXXXXXXXXXXXXXXXXXXX
