------------------------------------------------------------------------------------------------------------------------------------------------------
------------------------------------------------------------------------------------------------------------------------------------------------------
------------------------------------------------------------------------------------------------------------------------------------------------------
------------------------------------------------------------------------------------------------------------------------------------------------------
------------------------------------------------------------------------------------------------------------------------------------------------------
---------------------------------US-----------------------------------------------------------------------------------------------------------1-------
------------------------------------------------------------------------------------------------------------------------------------------------------
-------------------------------------------------------------------------oo---------------------------------------------------------------------------
---------------------------------------------------------------------y--------------------------------g---------------------------------------ggg-----
--------------------------------####--SSC------------------ooo-------##----------------C--------------TT-----------------S--------------##########---#
-----------!!-----------------####----------------------------------###-------------------------------TT-------------TT----------------##--------#---#
-------------------------y-#####-----------------------------------####-----------#-------------------TT-------------TT--------TT-----###--------#---#
----------------------y-######------------------y-y---------------#####---------------gg--------------TT----------gggTT------k-TT----####--------#---#
---------------------#######------XX--XXXXXXXXXXXXXXXX--XXXXXXXXXXXXXXX---XXXXXXXXXXXXXXXXXXXXXXXXXXXXXXX---XXXXXXXXXXXXXXXXXXXXXXXXXXXXX--------X---X
XXXXXXXXXXXXXXX--XXXXXXXXX--------XX--XXXXXXXXXXXXXXXX--XXXXXXXXXXXXXXX---XXXXXXXXXXXXXXXXXXXXXXXXXXXXXXX---XXXXXXXXXXXXXXXXXXXXXXXXXXXXX--------X---X
XXXXXXXXXXXXXXX--XXXXXXXXX----------------------------------------------------------------------------------------------------------------------------
