------------------------------------------------------------------------------------------------------------------------------------------------------
------------------------------------------------------------------------------------------------------------------------------------------------------
------------------------------------------------------------------------------------------------------------------------------------------------------
------------------------------------------------------------------------------------------------------------------------------------------------------
------------------------------------------------------------------------------------------------------------------------------------------------------
--------------------------------------------------------------------k---------------------------------------k-----------------------------------------
------------------------------------------------##-----------------S!S--S!S--------------------------------##----------------------------------##-----
------------------------------------------------##--------------------------------------------------------###---------------------------------###-----
----------------------------------------------####------------------------------------------#-----------k####--------------------------------####-----
------------------------------oo--------------####------------------------------------k-----#-----------#####-------------------------------#####-----
---------------------------------------------#####-----------------S!S--S@S--------SCSSS----#----------######--------------SS!S------------######-----
-------K-------------------------------------#####-----------------------------------K-----##---------#######-----------------------------#######-----
-----------------#---------------------------#####--------F--------------------------------##--------########--------F----------------tt-########-----
--M------------kk#----------------------ggg--#####--------#------k------ggg--------K---K---##-------#########--------#-----------gg---tt#########-----
XXXXXXXXXXXXXXXXXXXXXXXXXXXX------XXXXXXXXXX-XXXXXXXXXXXXXXXXXXXXXXXXXXXXXXXXXXXXXXXXXXXXXXXX---XXXXXXXXXXXXXXXXXXXXXXXXXXXXXXXXXXXXXXXXXXXXXXXXXXXXXX
XXXXXXXXXXXXXXXXXXXXXXXXXXXX------XXXXXXXXXX-XXXXXXXXXXXXXXXXXXXXXXXXXXXXXXXXXXXXXXXXXXXXXXXX---XXXXXXXXXXXXXXXXXXXXXXXXXXXXXXXXXXXXXXXXXXXXXXXXXXXXXX
