------------------------------------------------------------------------------------------------------------------------------------------------------------------------------------------------------------------------------------------------------------------------------------------------------------
------------------------------------------------------------------------------------------------------------------------------------------------------------------------------------------------------------------------------------------------------------------------------------------------------------
------------------------------------------------------------------------------------------------------------------------------------------------------------------------------------------------------------------------------------------------------------------------------------------------------------
------------------------------------------------------------------------------------------------------------------------------------------------------------------------------------------------------------------------------------------------------------------------------------------------------------
------------------------------------------------------------------------------------------------------------------------------------------------------------------------------------------------------------------------------------------------------------------------------------------------------------
-------------------------------------------------------------------------------------------------------------------------------------------------------------------------------------------------------------------------------------------k----------------------------------------------------------------
------------------------------------------------------------------------!!!!!-----------USSS--------SSCSS------SSSS--------------------------USS-----------------------------------------------------SSSS@SSS--------SSC------------------S!S--S!-----------------------------------------------------------
------------------------------------------------------------------------------------------------------------------------------------------------------------------------------------------------------------------------------------------------------------------------------------------------------------
----------------------------------------------------------------------------------------------------------------------------------------------------------------------------------B---------------------------------------------g#--------------------------------------------------------------------------
--------------------------------------------------------------------------k-------------------------------------------------------------------------------------------------------b-------------------K--------------SSS-------g##----------------------------------------SSUSSSSS--------------------------
-----------------------------------------------------------------TT-----@!!!!----------S-----TT---!!!!--!!!----------------------------------------------!!!!-------------------SS#CS---------------SSSSSSSSSS-----------------###--------S!S--S!----#------------------------------------------------------
-------K--------------------TT-----TT----K-----------------------TT--------------------------TT---------------------------tt-----------tt-----B---------------K-B-----K---B-------------------TT------------------------------####-------------------#-------K----------------------------------------------
----------------------------TT-----TT----------------------------TT--------------------------TT---------------------------tt-----------tt-----b-------B---------b---------b---------K-B-------TT-----------------------------#####-------------------#----------------------------------------------#-------
--M-----------ggg---------kkTT-----TT-----------ggg-------ggg----TT------------gg----k-ggg---TT------------ggg------------tt-g---------tt-g---B-------b---------b---------B-----------b-------TT-----------K----------------######------k------gg----#--------------------------------------------kk#-------
XXXXXXXXXXXXXXXXXXXXXXXXXXXXXXXXX--XXXXXXXXXXXXXXXXXXXXXXXXXXXXXXXXXXXXXXXXXXXXXXXXXXXXXXXXXXXXXXXXXXXXXXXXXXXX----XXXXXXXXXXXXXXXXXXXXXXXXXXXXXXXXXXXXXXXXXXXXXXXXXXXXXXXXXXXXXXXXXXXXXXXX--XXXXXXXXXXXXXXXXXXXXXXX----XXXXXXXXXX--XXXXXXXXXXXXXXXXXXXXXXX-X-XX-X-XX-XXXXXXXXXXXXXXXXX-X-X-XXXXXXXXXXXXXXXX
XXXXXXXXXXXXXXXXXXXXXXXXXXXXXXXXX--XXXXXXXXXXXXXXXXXXXXXXXXXXXXXXXXXXXXXXXXXXXXXXXXXXXXXXXXXXXXXXXXXXXXXXXXXXXX----XXXXXXXXXXXXXXXXXXXXXXXXXXXXXXXXXXXXXXXXXXXXXXXXXXXXXXXXXXXXXXXXXXXXXXXX--XXXXXXXXXXXXXXXXXXXXXXX----XXXXXXXXXX--XXXXXXXXXXXXXXXXXXXXXXX-X-XX-X-XX-XXXXXXXXXXXXXXXXX-X-X-XXXXXXXXXXXXXXXX
