--------------------------------------------------------------------------------------------------------------------------------------------------------------------------------------------------------
--------------------------------------------------------------------------------------------------------------------------------------------------------------------------------------------------------
--------------------------------------------------------------------------------------------------------------------------------------------------------------------------------------------------------
--------------------------------------------------------------------------------------------------------------------------------------------------------------------------------------------------------
--------------------------------------------------------------------------------------------------------------------------------------------------------------------------------------------------------
---------------------------------------------------------------------------------------------------------------------------------------------------------------------------------------oo---------------
---------------------------------------------------------------------------1---------------------------------------------------------------!------------------------------------------------------------
---------------------------------------------------------------------------------------------------------------------------------------------------------------oooo-------------------------------------
--------------------------------------------------------------------------------------------------------------------------------------------------------------------------------------------------------
------------------------------------------------------o---------------------------------------oo---oo---------------------------------------------------------------------------------------------------
----------------------------TT-------------------------------------------!!!!--------------------------------------------------------------@------------------------------TT------TT--------------------
-------K--------------------TT--------------------------------------------------------#-----------------------------------TT-----------TT--------------------#------------TT------TT--------------------
----------------------------TT--------------------------------------------------------#-----------------------------------TT-----------TT--------------------#------------TT------TT---------tt---------
--M-----------ggg-------ggg-TT----k-k------------k------------------------yy----------#----------------------k------kkk---TT-----------TT--------------------#---------y--TT-k----TT---ggg---tt-k----kkk
XXXXXXXXXXXXXXXXXXXXXXXXXXXXXXXXXXXXXXX-X-XX-XX-XXXXXXXXXXXXX----XXXXXXXXXXXXXXXXXXXXXXXXXXX-----X----XXXXXXXXXXXXXXXXXXXXXXXXXXXXXXXXXXXXXXXXXXXX--XXXXXXXXXXXXXXXXXXXXXXXXXXXXXXXXXXXXXXXXXXXXXXXXXXXX
XXXXXXXXXXXXXXXXXXXXXXXXXXXXXXXXXXXXXXX-X-XX-XX-XXXXXXXXXXXXX----XXXXXXXXXXXXXXXXXXXXXXXXXXX-----X----XXXXXXXXXXXXXXXXXXXXXXXXXXXXXXXXXXXXXXXXXXXX--XXXXXXXXXXXXXXXXXXXXXXXXXXXXXXXXXXXXXXXXXXXXXXXXXXXX
