----------------------------------------------------------------------------------------------------------------------------------------------------------------------------------------------------------------------------------------------------------
----------------------------------------------------------------------------------------------------------------------------------------------------------------------------------------------------------------------------------------------------------
----------------------------------------------------------------------------------------------------------------------------------------------------------------------------------------------------------------------------------------------------------
----------------------------------------------------------------------------------------------------------------------------------------------------------------------------------------------------------------------------------------------------------
-----------------------------------------------------------------------------------------------------------------------------------------------------------------------------------------------------------------XX---------------------------------------
-----------------------------------------------------------------------------------------------------------------------------------------------------------------------------------------------------------------XX---------------------------------------
------------------------------------------------------------------------!!!!!-----------USSS--------SSCSS------SSSS-----------------------------USSS-----------------------------------SSSSS---@-------------C---XX---------------------------------------
-----------------------------------------------------------------------------------------------------------------------------------------------------------------------------------------------------------------XX---------------------------------------
-----------------------------------------------------------------------------------------------------------------------------------------------------------------------------------------------------------------XX---------------------------------------
--------------------------------------------------------------------------k-----------------------------------------------g--------------------------TT----------------------------------------------------------XX---------------------------------------
-----------------------------------------------------------------TT-----@!!!!----------S-----TT---!!!!--!!!---------------TT-----------------TT------TT-----------------------------C--------!--------------SS---XX---------------------------------------
-------K--------------------TT-----TT----K-----------------------TT--------------------------TT---------------------------TT----------g------TT--tt--TT----------------------#---------------------TT------------XX---------------------------------------
----------------------------TT-----TT----------------------------TT--------------------------TT---------------------------TT----------TT-----TT--tt--TT------------------K---#---------------------TT------------XX--------F------------------------------
--M-----------ggg---------kkTT-----TT-----------ggg-------ggg----TT------------gg----k-ggg---TT------------ggg------------TT----------TT--g--TT--tt--TT-----k----------------#-----gg-------K-K----TT--------k---XX--------X------------------------------
XXXXXXXXXXXXXXXXXXXXXXXXXXXXXXXXX--XXXXXXXXXXXXXXXXXXXXXXXXXXXXXXXXXXXXXXXXXXXXXXXXXXXXXXXXXXXXXXXXXXXXXXXXXXXX----XXXXXXXXXX---XXXXXXXXXXXXXXXXXXXXXXXXXXXXXX---XXXXXXXXXX--XXXXXXXXXXXXXXXXXXXXXXXXXXXXXXXXXXXXXXXXXXXXXXX------------------------------
XXXXXXXXXXXXXXXXXXXXXXXXXXXXXXXXX--XXXXXXXXXXXXXXXXXXXXXXXXXXXXXXXXXXXXXXXXXXXXXXXXXXXXXXXXXXXXXXXXXXXXXXXXXXXX----XXXXXXXXXX---XXXXXXXXXXXXXXXXXXXXXXXXXXXXXX---XXXXXXXXXX--XXXXXXXXXXXXXXXXXXXXXXXXXXXXXXXXXXXXXXXXXXXXXXX------------------------------
