----------------
----------------
----------------
----------------
----------------
----------------
----------------
----------------
----------------
----------------
----------------
-------K--------
----------------
--M-----------gg
XXXXXXXXXXXXXXXX
XXXXXXXXXXXXXXXX
