-----------------------------------------------------------------------------------------------------------------------
-----------------------------------------------------------------------------------------------------------------------
-----------------------------------------------------------------------------------------------------------------------
-----------------------------------------------------------------------------------------------------------------------
-----------------------------------------------------------------------------------------------------------------------
-----------------------------------------------------------------------------------------------------------------------
-------------------------------------------------------------------------------------------------------------##--------
-------------------------------------------------------------------------------------------------------------##--------
-----------------------------------------------------------------------------------------------------------#-##--------
----------------------------------o----o-------------------oo---oo-----------------------------------------#-##--------
---------------------------------------------------------------------------------------------------------#-#-##--------
-------K--------------------TT---------------------------------------------------------TT----------------#-#-##--------
----------------------------TT----------------#---#------------------------------------TT---------TT---#-#-#-##--------
--M-----------ggg---------kkTT----------------#-k-#-----------------------k------kkk---TT---------TT---#-#-#-##--------
XXXXXXXXXXXXXXXXXXXXXXXXXXXXXXXXX---XX---XXXXXXXXXXXXXXXX-----X----XXXXXXXXXXXXXXXXXXXXXXXXXXXXXXXXXXX-X-X-X-XXXXXXXXXX
XXXXXXXXXXXXXXXXXXXXXXXXXXXXXXXXX---XX---XXXXXXXXXXXXXXXX-----X----XXXXXXXXXXXXXXXXXXXXXXXXXXXXXXXXXXX-X-X-X-XXXXXXXXXX
