----------------------------------------------------------------------------------------------------------------------------------------------------------------------------------------------------------------------------------------------------------
----------------------------------------------------------------------------------------------------------------------------------------------------------------------------------------------------------------------------------------------------------
----------------------------------------------------------------------------------------------------------------------------------------------------------------------------------------------------------------------------------------------------------
----------------------------------------------------------------------------------------------------------------------------------------------------------------------------------------------------------------------------------------------------------
----------------------------------------------------------------------------------------------------------------------------------------------------------------------------------------------------------------------------------------------------------
---------------------------------------------------------------------------------------------oo-----------------------------------------------------------------------------------------------------------------------------------------------------------
------------------------------------------------------------------------------------------------------------------------------------------SSSSCSSS--------------------------------------------------------------------------------------------------------
--------------------------TT------------------------------------------------------------------------------------------------------------------------------------------------------------------------------------------------------------------------------
--------------------------TT------------------------------------------------------------------------------------------------------------------------------------------------------------------------------------------------------------------------------
----------------------TT--XX------------------------------o---------------1--------o------------------------------------------------------------------------------------SSUSSSSS-----------------------------oo----------------------------o--------------
-------SSS------------TT----------------------------------------------TT----------------TT-----------------------------------------------#----2----#------------------------------------------------------------------------------------------------------
----------------------TT----------------------------------------------TT----TT----------TT----------------------------------TT-----------#------K--#-------K----------------------------------------------------------------------------------------------
----------------TT----TT-------TT-------------------------------------TT----TT----------TT---------tt-----------------------TT-----------#---------#-----------K----------------------------------#-------------------------------------------------------
--M-----------k-TT----TT-------TT-g----k-------------k---------ggg----TT---kTT----------TT---ggg---tt-k----kkk---kkk--------TT------ggg--#---------#--------------------------------------------kk#--------------------ggg------------k---------ggg-------
XXXXXXXXXXXXXXXXXXXXXXXXXXXXXXXXXXXXXXXXX--XX-XX-XX-XXXXXXXXXXXXXXXXXXXXXXXXXXXXXXXXXXXXXXXXXXXXXXXXXXXXXXXXXXXXXXXXXXXXXXXXXXXXXXXXXXXXXXXXXXXXXXXXXXXXX-X-XX-X-XX-XXXXXXXXXXXXXXXXX-X-X-XXXXXXXXXXXXXXXXX------XXXXXXXXXX-XX-XX-XX-XXXXXXXXXXXXXXXXXXXXX
XXXXXXXXXXXXXXXXXXXXXXXXXXXXXXXXXXXXXXXXX--XX-XX-XX-XXXXXXXXXXXXXXXXXXXXXXXXXXXXXXXXXXXXXXXXXXXXXXXXXXXXXXXXXXXXXXXXXXXXXXXXXXXXXXXXXXXXXXXXXXXXXXXXXXXXX-X-XX-X-XX-XXXXXXXXXXXXXXXXX-X-X-XXXXXXXXXXXXXXXXX------XXXXXXXXXX-XX-XX-XX-XXXXXXXXXXXXXXXXXXXXX
