-----------------------------------------------------------------------------------------------------------------XXXXXXXXXXXXXXXXXXXXXXXXXXXXXXXXXX-X-XX-XX-XX-XXXXXXXXXXXXXXXXXXXXXXXXXXXXXXXXXXXXXXXXXXXXXXXXXXXXXXXXXXXXXXXXXXXXXXXXXXXXXXXXXXXXXXXXXXXXXXXXXXXXXX--XXXXXXXXXXXXXXXXXXXXXXXXXXXXXXXXXXXXXXXXXXXXXXXXXXXXXXXXXXXXXXXXXXXXXXXXXXXXX-XXXXXXXXXXXXXXXXXXXXXXXXXXX-
---------------------------------------------------------------------------------------------------------------------------------------------------------------------------------------------------------------------------------------------------------------------------------------------------------------------------------------------------------------------------------
---------------------------------------------------------------------------------------------------------------------------------------------------------------------------------------------------------------------------------------------------------------------------------------------------------------------------------------------------------------------------------
---------------------------------------------------------------------------------------------------------------------------------------------------------------------------------------------------------------------------------------------------------------------------------------------------------------------------------------------------------------------------------
----------------------------------------------------------------------------------------------------------------------------------------------------------------------------------------------------------------------------------------------------------------------------------------------------------------------------------------------------U----------------------------
---------------------------------------------------------------------------------------------------------------------------------------------------------------------------------------------------------------------------------------------------------------------------------------------------------------------------------------------------------------------------------
-----------------------------------------SUS----------------------------------------------------------------------------------------------------------------------------------------------------------------------------------------------------------------------------------------K---------------------------------------------------------------------------------k----------
------------------------------------------------------------------------------------------------------------------------------------------------------------------------------------------------------------------------USS-----------------------------------------------------SSSSSS----1----------------------------------------SSSSS------------------------------##---------
------------------------------------------------------------------------------------------------------------------------------------------------------------------------------------------------------------------------------------------------------------------------------------------------------------------------------------------------------SS-------------###---------
-------------------------------------------------------------------------------------------------------------------------------------------------------------------------------------------------------------------------------------------------------------B---------------------------------------------------------------------------------------------#--------####---------
----------------------------------------#####-----------------------------------------------------#LSS--------#-------------------------------------------------------o---------------1--------o--------o----------------------------------------------------b-------------------K--------------------------------------------------K-------------SS------##-------#####---------
-------K--------------------------------#--------------------------#------------------------------#----------##-T------------------------TT---------------------------------------TT----------------TT------------------------------!!!!-------------------SS#CS---------------SSSSSSS---------------------------------------------SSSSS-----------------###------######---------
---------------------------------------K#---------------------*----#------------------------------#----------##-TT-----------------------TT---------------------------------------TT----TT----------TT---------------K---B---------------K-B-----K---B-------------------TT---------------TT--------------TT--------------------------K---#----B--------####-----#######---------
--M-----------ggg--------ggg------------#--------------ggg----*----#----ggg--k----ggg-----------kk#----------##-TTX----------------------TT---------------------------------------TT----TT----------TT----------B--------b-------B---------b---------b---------K-B-------TT---------------TT---------B----TT----TT-----B-----TT-----------#----b-------#####----########--------F
XXXXXXXXXXXXXXXXXXXXXXXXXXXXXXXXXXXXXXXXXXX----XXXXXXXXXXXXXXXXXX--XXXXXXXXXXXXXXXXXXXXXXXXXXXXXXXXXXXX---XXXXX-XXX-------k-ggg------ggg-TT----k-k---------------k---------ggg----TT---kTT----------TT----------b--------B-------b---------b---------B-----------b-------TT---------------TT---------b----TT-k--TT-----b-----TT-----------#----B------######---#########--------#
XXXXXXXXXXXXXXXXXXXXXXXXXXXXXXXXXXXXXXXXXXX----XXXXXXXXXXXXXXXXXX--XXXXXXXXXXXXXXXXXXXXXXXXXXXXXXXXXXXX---XXXXX-XXXXXXXXXXXXXXXXXXXXXXXXXXXXXXXXXXXX-X-XX-XX-XX-XXXXXXXXXXXXXXXXXXXXXXXXXXXXXXXXXXXXXXXXXXXXXXXXXXXXXXXXXXXXXXXXXXXXXXXXXXXXXXXXXXXXXXXXXXXXXXXXXXXXXX--XXXXXXXXXXXXXXXXXXXXXXXXXXXXXXXXXXXXXXXXXXXXXXXXXXXXXXXXXXXXXXXXXXXXXXXXXXXXX-XXXXXXXXXXXXXXXXXXXXXXXXXXX
