--------------------------------------------------------------------------------------------------------------------------------------------------------
--------------------------------------------------------------------------------------------------------------------------------------------------------
--------------------------------------------------------------------------------------------------------------------------------------------------------
--------------------------------------------------------------------------------------------------------------------------------------------------------
--------------------------------------------------------------------------------------------------------------------------------------------------------
--------------------------------------------------------------------------------------------------------------------------------------------------------
------------------------------------------SUS------------------------------------------------------------------------------------------------##---------
---------------------------------------------------------------------------------------------------------------------------------------------##---------
------------------------------------------------------------------------------------------------------------TT-------------------------------##---------
------------------------------------------------------------------------------------------------------------TT------------------------K---#--##---------
-----------------------------------------#####-----------------------------------------------------#LSS-----##---------------------------##--##---------
-------K---------------------------------#--------------------------#------------------------------#------------------------------------###--##---------
----------------------------------------K#---------------------*----#------------------------------#-----------*---TT-----*------------####------------F
--M-----------ggg-------ggg--------------#--------------ggg----*----#----ggg--k----ggg-----------kk#-----------*---TT-----*-----K-----#####------------#
XXXXXXXXXXXXXXXXXXXXXXXXXXXXXXXXXXXXXXXXXXXX----XXXXXXXXXXXXXXXXXX--XXXXXXXXXXXXXXXXXXXXXXXXXXXXXXXXXXXX---XXXXXXXXXXXXXXXXXXXXXXXXXXXXXXXXXXXXXXXXXXXXX
XXXXXXXXXXXXXXXXXXXXXXXXXXXXXXXXXXXXXXXXXXXX----XXXXXXXXXXXXXXXXXX--XXXXXXXXXXXXXXXXXXXXXXXXXXXXXXXXXXXX---XXXXXXXXXXXXXXXXXXXXXXXXXXXXXXXXXXXXXXXXXXXXX
