------------------------------------------------------------------------------------------------------------------------------------------------------------------------------------------------------------------------------------------------------------------------
-------------------------------------------------------------------------------------------------------------------------------------------------------SS---------------------------------------------------------------------------------------------------------------
-------------------------------------------------------------------------------------------------------------------------------------------------------SS--SSSSSSSSSSSSSSSSSS-------------------------------------------------------------------------------------------
-------------------------------------------------------------------------------------------------------------------------------------------------------SSk--------------------------------------------------------------------------------------------------------------
------------------------------------------------------------------------------------------------------------------------------------------------------USSS---------------------------------------------------------------------------------------------------##---------
-------------------------------------------------------------------------------------------------------------------------------------------------------------------------------SSS---------------------------------------------------------------------------##---------
--------------------------------------------------------------------------------------------------------------U-S--------SSCSS------SSSS---------------------------------------------------------------------------------------------------------------------##---------
------------------------------------------------------------------------------------------------------------------------------------------------------------------------------------------------------------------------------------------------------------###---------
-------------------------------------------------------------------------------------TT---------------------------------------------------------------------------------------------SSSSSSU------------------------------------------------------------K---####---------
-------------------------------------------------------------------------------------TT--------------------------------------------------------g----S------T--------------g##-------------------------------------------------TT--------------------------#####---------
----------------------------------------------------------------------------#LSS-----##---------------------------TT---!!!!--!!!---------------TT-----y---#T--------------###----------------------------------------TT-----TTTT-------------------------######--------F
-------K--------------------TT-----TT----K----------------------------------#-------------------------------------TT---------------------------TT----SS--##T------------g####--SSS-----------------------------------TT-----TTTT----TT-----*------------#######--------#
----------------------------TT-----TT---------------------------------------#-----------*---TT-----*-----------B--TT---------------------------TT--SS-XXXXXT--k---------#####---------r----------------ggg---------kkTT-----TTTT----TT-----*-----K-----######XXXXXXXXXXX
--M-----------ggg---------kkTT-----TT-----------ggg-------ggg-------------kk#-----------*---TT-----*-----K-----b--TT------------ggg------------TT-----XXXXXXXXXXXXXXXXXXXXXXX-------XXXXXXXX--X-XXXXXXXXXXXXXXXXXXXXXXXXXX--XXXXXXXXXXXXXXXXXXXXXXXXXXXXXXXXXXXXXXXXXXXX
XXXXXXXXXXXXXXXXXXXXXXXXXXXXXXXXX--XXXXXXXXXXXXXXXXXXXXXXXXXXXXXXXXXXXXXXXXXXXXXX---XXXXXXXXXXXXXXXXXXXXXXXXXXXXXXXXXXXXXXXXXXXXXXXX----XXXXXXXXXX---------XXXXXXXXXXXXXXXXXX-------XXXXXXXX--X-XXXXXXXXXXXXXXXXXXXXXXXXXX--XXXXXXXXXXXXXXXXXXXXXXXXXXXXXXXXX-----------
XXXXXXXXXXXXXXXXXXXXXXXXXXXXXXXXX--XXXXXXXXXXXXXXXXXXXXXXXXXXXXXXXXXXXXXXXXXXXXXX---XXXXXXXXXXXXXXXXXXXXXXXXXXXXXXXXXXXXXXXXXXXXXXXX----XXXXXXXXXX----------------------------------------------------------------------------------------------------------------------
