---------------------------------------------------------------------------------------------------------------------XXXXXXXXXXXXXXXXXXXXXXXXXXXXXXXXXXXXXXXXXXXXXXX------XXXXXXXXXXXXXXXXXXXXXXXXXXXXXXXXXXXXXXXXXXXXXXXXXXXXXX--XXXXXXXXXX--XXXXXXXXXXXXXXXXXXXXXXXXXXXXXXXXXX-
---------------------------------------------------------------------------------------------------------------------------------------------------------------------------------------------------------------------------------------------------------------------------------
---------------------------------------------------------------------------------------------------------------------------------------------------------------------------------------------------------------------------------------------------------------------------------
---------------------------------------------------------------------------------------------------------------------------------------------------------------------------------------------------------------------------------------------------------------------------------
---------------------------------------------------------------------------------------------------------------------------------------------------------------------------------------------------------------------------------------------------------------------------------
---------------------------------------------------------------------------------------------------------------------------------------------------------------------------------------------------------------------------------------------------------------------------------
----------------------------------------------------------------------------------------------------------------------------------oo------------------------------------------------------------------------------o--------------------------------------------------------------
----------------------------------------------------------------------------------------------------------------------------------------------------------------1----------------------------------------------------------------------------------------SSSSS-------------------
--------------------------------------------------------------------------------------#-------------------------------------------------------------------------------y---------------oooo---------------------------------------------------------------------------------------
-----------------------------oo---------------------tt-------------------------------##--oo------o----o-------------------------------------------------------------#SS--o-------------------------------------------------------------------------------------------------------
------------------------------------------------TT--tt------------------------------###-----------------------------T----------------------------------------------##----------------------------------o-------------------------------------------------------------------------
-------K------------------------------------TT--TT--tt-----------------------------####-----------------------------T--------TT-----------------------------------###--SC----------TT--------------TT--------TT---------------------------------------C--------!-----------------
---------------#----------------------------TT--TT--tt----------------------------#####----------------------#---#--TT-------TT------------TT---------------------###--------------TT--------------TT--------TT--------------------------------#---------------------TT----------
--M----------kk#-----------------------ggg--TT--TT--tt-----k--ggg-----ggg------gg######--k-------------------#-k-#--*T-------TT---------tt-TT--------------------####---SSSy-------TT--------------TT--------TT----------------------------K---#---------------------TT---B-----F
XXXXXXXXXXXXXXXXXXXXXXXXXXX------XXXXXXXXXX-XX--XX--XXXXXXXXXXXXXXXXXXXXXXXXXXXXXXXXXXXXXXXXXXXX---XX---XXXXXXXXXXXXXX-------TT---ggg---tt-TT------k-ggg------gg#####------S----y--TT---y------y---TT--------TT---ggg---g-g----y---------------#-----gg-------K-K----TT---b-----#
XXXXXXXXXXXXXXXXXXXXXXXXXXX------XXXXXXXXXX-XX--XX--XXXXXXXXXXXXXXXXXXXXXXXXXXXXXXXXXXXXXXXXXXXX---XX---XXXXXXXXXXXXXXXXXXXXXXXXXXXXXXXXXXXXXXXXXXXXXXXXXXXXXXXXXXXXX------XXXXXXXXXXXXXXXXXXXXXXXXXXXXXXXXXXXXXXXXXXXXXXXXXXXXXX--XXXXXXXXXX--XXXXXXXXXXXXXXXXXXXXXXXXXXXXXXXXXX
