----------------------------------------------------------------------------------------------------------------------------------------------------------------------------------------
----------------------------------------------------------------------------------------------------------------------------------------------------------------------------------------
----------------------------------------------------------------------------------------------------------------------------------------------------------------------------------------
----------------------------------------------------------------------------------------------------------------------------------------------------------------------------------------
----------------------------------------------------------------------------------------------------------------------------------------------------------------------------------------
----------------------------------------------------------------------------------------------------------------------------------------------------------------------------------------
--------------------------------------------------------------------------SUS------------------------------------------------------------------------------------------------##---------
-----------------------------------------------------------------------------------------------------------------------------------------------------------------------------##---------
--------------------------------------------------------------------------------------------------------------------------------------------TT-------------------------------##---------
--------------------------------------------------------------------------------------------------------------------------------------------TT------------------------K---#--##---------
-------------------------------------------------------------------------#####-----------------------------------------------------#LSS-----##---------------------------##--##---------
-------K--------------------TT-----TT----K-------------------------------#--------------------------#------------------------------#------------------------------------###--##---------
----------------------------TT-----TT-----------------------------------K#---------------------*----#------------------------------#-----------*---TT-----*------------####------------F
--M-----------ggg---------kkTT-----TT-----------ggg-------ggg------------#--------------ggg----*----#----ggg--k----ggg-----------kk#-----------*---TT-----*-----K-----#####------------#
XXXXXXXXXXXXXXXXXXXXXXXXXXXXXXXXX--XXXXXXXXXXXXXXXXXXXXXXXXXXXXXXXXXXXXXXXXX----XXXXXXXXXXXXXXXXXX--XXXXXXXXXXXXXXXXXXXXXXXXXXXXXXXXXXXX---XXXXXXXXXXXXXXXXXXXXXXXXXXXXXXXXXXXXXXXXXXXXX
XXXXXXXXXXXXXXXXXXXXXXXXXXXXXXXXX--XXXXXXXXXXXXXXXXXXXXXXXXXXXXXXXXXXXXXXXXX----XXXXXXXXXXXXXXXXXX--XXXXXXXXXXXXXXXXXXXXXXXXXXXXXXXXXXXX---XXXXXXXXXXXXXXXXXXXXXXXXXXXXXXXXXXXXXXXXXXXXX
