---------------------------------------------------------------------------------------------------------------------------------------------------------------------------------------------------------------------------------------------------
---------------------------------------------------------------------------------------------------------------------------------------------------------------------------------------------------------------------------------------------------
---------------------------------------------------------------------------------------------------------------------------------------------------------------------------------------------------------------------------------------------------
---------------------------------------------------------------------------------------------------------------------------------------------------------------------------------------------------------------------------------------------------
---------------------------------------------------------------------------------------------------------------------------------------------------------------------------------------------------------------------------------------------------
----------------------------------------------------------------------------------------------------------------------------------------------------------------------------------------------------------------------------------------y----------
----------------------------------------SUS--------------------------------------------------------------------------------------------------------------------------!!!!---------------------------------------------------------------##---------
-----------------------------------------------------------------------------------------------------------------------------------------ooooo----------oooo--------------------------------------------------------------------------y###---------
----------------------------------------------------------------------------------------------------------TT--------------------------------------------------------------------------------------------------------------------------####---------
----------------------------------------------------------------------------------------------------------TT------------------------K----------------------------------y-------------------------------------------------------------#####---------
---------------------------------------#####-----------------------------------------------------#LSS-----##---------------------------#-------------TT------------!!@SS!!!---------------------------------------------------------######---C-----
-------K-------------------------------#--------------------------#------------------------------#------------------------------------##-------------TT-------------------------------------------------------#--------------------#######---------
--------------------------------------K#---------------------*----#------------------------------#-----------*---TT-----*------------###-------------TT-----------------------------TT------------------------#-------------------########--------F
--M-----------ggg-------ggg------------#--------------ggg----*----#----ggg--k----ggg-----------kk#-----------*---TT-----*-----K-----####----------y--TT-----------------------------TT------------------------#----y--y----------#########--------#
XXXXXXXXXXXXXXXXXXXXXXXXXXXXXXXXXXXXXXXXXX----XXXXXXXXXXXXXXXXXX--XXXXXXXXXXXXXXXXXXXXXXXXXXXXXXXXXXXX---XXXXXXXXXXXXXXXXXXXXXXXXXXXXXXXXXXXXXXXXXXXXXXXXXXXXXXXXXXXXX--XXXXXXXXXXXXXXXXXXXXXXX---XXX--XXXXXXXX--XXXXXXXXXXXXXXXXXXXXXXXXXXXXXXXXXX
XXXXXXXXXXXXXXXXXXXXXXXXXXXXXXXXXXXXXXXXXX----XXXXXXXXXXXXXXXXXX--XXXXXXXXXXXXXXXXXXXXXXXXXXXXXXXXXXXX---XXXXXXXXXXXXXXXXXXXXXXXXXXXXXXXXXXXXXXXXXXXXXXXXXXXXXXXXXXXXX--XXXXXXXXXXXXXXXXXXXXXXX---XXX--XXXXXXXX--XXXXXXXXXXXXXXXXXXXXXXXXXXXXXXXXXX
