----------------------------
----------------------------
----------------------------
----------------------------
----------------------------
----------------------------
-----------------##---------
-----------------##---------
-----------------##---------
--------------#--##---------
-------------##--##---------
-------K---y###--##---------
-----------####------------F
--M-------#####------------#
XXXXXXXXXXXXXXXXXXXXXXXXXXXX
XXXXXXXXXXXXXXXXXXXXXXXXXXXX
