--------------------------------------------------------------------------------------------------------------------------------------------||----|||--------------------------------------------------------------------------
-------------------------------------------------------------------------------------------------------------------------------------------------------------------------------------------------------------------------------
------------------------------------------------------------------------------------------------------------------------------------------------------%------------------------------------------------------------------------
-------------------------------------------------------------------------------oo-------------------------------------------------------------------------o--------------------------------------------------------------------
--------------------------------------------------------------------------------------g-g--------------------------------------------------------------------------------------------------------------------------------------
---------------------------------------------------------------------ooor---------%%%%%%%-------------oooo----------R--------------------------------------%---gg--oo--oo------------------------------------------------------
--------------------------------------------------------------------%%%%%----------|||||--------------%%%%----------------g----oo------oo--oo---------------%%%%%-----------------------R-----oo--------------------##---------
---------------------------------------------------------------------|||-----------|||||----oo---------||-------------%%%%%%-------------------------%------||||--------------------r-------------------------------##---------
---------------------------------------------------------------------|||-----------|||||---------------||--------------||||-------------------------%|------||||--------------%%%%%%%%-------------------SSS------####---------
--------------------------------oo---oo------------------------------|||-----%%%%%-|||||---------SSS---||--------------||||-----SS----------------%%%|------||||---------------||||||-----------------------------####---------
------------------------------------------------------------------%%%%%%%%----|||--|||||---------------||-------%%%----||||------------------------|||------||||----SS---------||||||-----%%%%--%%%%------------######---------
-------K-----------------------------------------------------------||||||-----|||--|||||-------------U-||--------|-----||||-------------SS---------|||------||||---------------||||||------||----||-------------######---------
-----------------#-------------------------------------------------||||||--o--|||--|||||---------------||--------|-----||||------------------------|||------||||--------%%%%---||||||------||----||-------------######--------F
--M------------kk#-----------------------------k------------%%%%---||||||-%%%-|||--|||||---------------||--------|-----||||-----------------%%%%---|||------||||---------||----||||||--ooo-||----||---------r---######--------#
XXXXXXXXXXXXXXXXXXXXXXXXXXXXXX-----X----XXXXXXXXXXXXXXXXXX---||----||||||--|--|||--|||||----%%%%-----%%%%%-%%%%%-|-----||||------------------||----|||%-----||||---------||----||||||--%%%-||----||----XXXXXXXXXXXXXXXXXXXXXXXX
XXXXXXXXXXXXXXXXXXXXXXXXXXXXXX-----X----XXXXXXXXXXXXXXXXXX---||----||||||--|--|||--|||||-----||-------|||---|||--|-----||||------------------||----||||------------------||----||||||---|--||----||----XXXXXXXXXXXXXXXXXXXXXXXX
