-----------------------------------------------------------------------------------------------
-----------------------------------------------------------------------------------------------
-----------------------------------------------------------------------------------------------
-----------------------------------------------------------------------------------------------
-----------------------------------------------------------------------------------------------
---------------------------------------------k---------------------------------------k---------
--------------------------------------------S!S--S!S--------------------------------##---------
-----------------------------------------------------------------------------------###---------
---------------------------------------------------------------------#-----------k####---------
-----------------------------------tt--------------------------k-----#-----------#####---------
-----------------------------------tt-------S!S--S@S--------SCSSS----#----------######---------
-------K--------------------TT-----tt-------------------------K-----##---------#######---------
----------------------------TT-----tt-------------------------------##--------########--------F
--M-----------ggg---------kkTT-----tt-----k------ggg--------K---K---##-------#########--------#
XXXXXXXXXXXXXXXXXXXXXXXXXXXXXXXXX--XXXXXXXXXXXXXXXXXXXXXXXXXXXXXXXXXXX---XXXXXXXXXXXXXXXXXXXXXX
XXXXXXXXXXXXXXXXXXXXXXXXXXXXXXXXX--XXXXXXXXXXXXXXXXXXXXXXXXXXXXXXXXXXX---XXXXXXXXXXXXXXXXXXXXXX
