---------------------------------------------------------------------------------
---------------------------------------------------------------------------------
---------------------------------------------------------------------------------
---------------------------------------------------------------------------------
---------------------------------------------------------------------------------
---------------------------------------------------------------------------------
----------------------------------------------------------------------##---------
----------------------------------------------------------------------##---------
-------------------------------------TT-------------------------------##---------
-------------------------------------TT------------------------K---#--##---------
----------------------------#LSS-----##---------------------------##--##---------
-------K--------------------#------------------------------------###--##---------
----------------------------#-----------*---TT-----*------------####------------F
--M-----------ggg---------kk#-----------*---TT-----*-----K-----#####------------#
XXXXXXXXXXXXXXXXXXXXXXXXXXXXXXXXX---XXXXXXXXXXXXXXXXXXXXXXXXXXXXXXXXXXXXXXXXXXXXX
XXXXXXXXXXXXXXXXXXXXXXXXXXXXXXXXX---XXXXXXXXXXXXXXXXXXXXXXXXXXXXXXXXXXXXXXXXXXXXX
