----------||---------|||--------------%%%%%-------------|||-||-------------------------S-----------------------#######--------------------------------
----------||--R-----------------------||||--------------|||-||-----------------------------------------------#########--------#----------!S!-----SS-o-
----------|---------------------------||||--------------|||--------------------------------------------------#########--------#-----------------------
--------------------------------------||----------------||---------------------------S-----1-----------------#########--------#-----------------------
-----------------------------S----------------------------------------S------------------------#-----y-------#########----g---#---k------k-------k----
-----------------------------------------------------------------------------------------------#---XXXXXXXXXXXXXXXXXXXXXXXXXXXXXXXX-XXXXXXXXXXXXXXX---
----------------------------------o-------------------SS-----------SS--------------------------#---XXXXXXXXXXXXXXXXXXXXXXXXXXXXXXXX-XXXXXXXXXXXXXXX---
-------------------------%----S--------------------------o-------------------------------------XX-----------------------------------------------------
------------------------r------S------------------------------------------XXXXXXXXXXXXX--X-----XX-----------------------------------------------------
----------%-%-----o---%%%---------SSS-------------------------------------XXXXXXXXXXXXX--X------------------------------------------------------------
----%%%%%--%|------S---|--%%%--------SC-----------------%----%----------------------------------------------------------------------------------------
-----||||%-||----------|o-||--------------------------------%-----------------------------------------------------------------------------------------
-----|||||%||%-------%o|r-||---------------------------o-----------------------------------------------------------y----------------------------------
%%%%-|||||-||---------%%%-||-----------------------------%-%%------------------------------------------------------#------------------------------S@--
-||--|||||-||---------|||%-------------------------------|%|-%%%-------------------------------------------o-------##-#-------------------------------
-||--|||||-||---------|||--------------------------------|||-||--------------------------S------------------------#####-------------------------------
