-------------------SSSSSSS--SSSS----S--S--SbS---SXS----#SS#----##SS----------------S----S-----S-------------T----S-SS-SSS--S--------SSSS-SSSS--SX-----
-------------------S-SS-bS--SS-S----S--S--SSSS--SXS----#SS#----##LS------X---S-----S----S-----S-------------T-S--S-SS-SSS--S--X-----SSSS--SSS-#SX---S-
-------------------SoSSoSS--SS-S----S--S--SSSS--SXSS---#SXXXXXXXXXXXXXXX-X--SSSSSSSSSS-o------S-SS--SS-S-S--T--S-S-SS--SS--SUoX----1--SS--SSSy#SX-----
------------------oSS-SSS----S---------S----SS--SX-X--XXXXXXXXXXXXXXXXXX------SSSSS-S-XS--------S-----------T----------SSo----X-SS-X--SS--SX-##SX-S---
----------------#-SS---------S---S-----S----SSXXXX-X--XXX-----S---------------SSSSS-SSX---------S-S-------XXX----------S------S-SS----SS-SSX-XXXX----o
----------------#-SS---------S----o----S----SXXXXX-X----------S-----------SSS-SCSSS-SSX---------SSS---S---XXX------o---S------S-SS---SSS-SS--XXXX-----
---------S------#--S-o---g--US-S------!S--SS-X-----XX--S------S----------SSS------S--SX--S-2----------S------------S---S------S-SX------#SX-------!--X
----------------#--S-SS--K-----S-----o-------------XX----SSSSSSS-SSSS---S-SS-S----S--SX!---S----------S------------------------XXXXX----#SX----------X
----------------#--S-SS-#------S------------------S---SS-SS-S--S-S--S----SSS-S-o--S--SX----S------o--oS-o----S---S------#------XXXXX----#S-SS-----S---
----------------#--S#-S##-----gS--g--y---------SSSS------SS-S--S-SS-S-----S-SS-S-SSSgSX-----------------S---SS---S---k--#-----------XXXXXX-SSSS-So----
-----------t----#---#--##XXXXXXXXXXXXXXXXXXXSS-SSSX------SSoS--S-SS-S----S-S-SS----SS------------------------S-XXXXXXXXXXXXXXXX-----XXXXXX-SSSSgS----S
-----------t----#---XXXXXXXXXXXXXXXXXXXXXXXX-SSSSSXSS--S-S-------------------SS----SS--------S---------------S-XXXXXXXXXXXXXXXX-----------SSSSSSS-----
-----------t----#---XXXXX--------------------SSSSSXSSS-S---------------------SS----SS---------------k--------S-----------------S-SSSS-----S--SSSS-S---
----------gt---##----------------------------SS-S-X-SS-S---g--------------!--X-XXXXXXXX----------XXXXXXXXX------------------------SS------S--S-------S
XXXXXXXXXXXXXXXXX-----------------------o---SS--S-X-SS-S#-S#--#U--SS---------X-XXXXXXXX--S-------XXXXXXXXX----S-------------------SSSSSSS-S--S---X----
XXXXXXXXXXXXXXXXX--------SSS-SSSSSS-SSSSSSSSSS--SSX----S#SS#----#-SS----------------S---------SS------------S----oSSSS-SSSSoSSS-S-SS2SSSS-SLSS---X----
