----X---------T--g---X-----T#---------X-----X----------Xk----X----X----------XX--XX----TS------XX-------X-----X---X------#---X----US------X-----------
------------X-X--T---X-X-X-T----------X--SS-X----------XX--S!---------------XX---------X----XX----------X----------------X---------X------X-----------
------------X-X--X---tX--XXT--X----------X--------------X---------k--------------------X-----#---X------X--LX--k---------X------------------------X---
----------!T-----X-X-XT---XT--X----------t----!-----X---X--------------------------S---X-----X---X---------X---X--T-T-X----!--------X--------X-X--X-S-
-----------X-------X-T--U-#T-------------X---XX----gX---t-------Xg---------X-----------X-----X-------------X--Xt--X-XS-------------------X---X--------
-----------X-------X-XX---XT----X---S--------X-----X--X-X--------X---------X-----------------------X-----X----X---X-X----------#-------------X--------
------------X------!-#X---XT-------------XX--------X--X--X-----#-X--C------X-X---X-----!-----------XX---XX--------X---X------X-X-------------XX-X-----
------------X--------XX----T------X---X--XX--------S--X--X-----X---------X---Xg--------X-----X----------X-------------X------X---------X----X-X----X--
-----X-------@t------XX----#------X-XX----X---------X----X-----X---------!---XT--------------X--------S---------------X------#---------X----X------X--
-----X-------T-S-----------T------X-X-------X--X---------------------X--------T---------------------------------------X------#-X------------T---------
-------------T-------------t----------------T--X---------------------X----g---T-------X-----X--------------X-X----------!----X-#----------------------
-------------X-----------X-T-----X----S-----X-----------!@-----------X-X-XTX--X------X------X--------------X-X-----T--g------X-X----------------------
-------------X-----------X-T-----X---g-----SX---U--------X-----------X-XXXT--XX------X------X--------X----X----K-C-T--X-----X--X----------------------
-----------X-X-------------X--------------------X-X------X---X----X--X-XXX#--X------------------T---------X-X--#-k-TX-X-k----------!-------------X----
XXXXX------X-----X-X-------X----------------------X--X------------X--XXX--XX-X--X---------------X--X---X---X---T-X-T--X-X-X------X---------------X----
XXXXXX-----X-----X-X-------X-#-----------------------X------------XX--X---XX-X-XX-XX--------X---XX-X---X---X---X-X-X----X-T---X--X---------T----M-----
