------------------XXXXXXXXXXXXXXXXXXXXXXXXXXXXXX---XXXXXXXXXXXXXXXXXXXXXXXXXXXXXXXXXXXXXXXXXX---XXXXXXXXXXXXXXXXXXXXXXXXXXXXXXXXXXXXXXXXXXXXXX---XXXXX
------------------------------------------------------------------------------------------------------------------------------------------------------
------------------------------------------------------------------------------------------------------------------------------------------------------
------------------------------------------------------------------------------------------------------------------------------------------------------
------------------------------------------------------------------------------------------------------------------------------------------------------
------------------------------XX----------------------------------------------------------------------------------------------------------------------
------------------------------XX----------------------------------------------------------------------------------------------------------------------
--------------------------C---XX--------------------------SS-S---!----SSSSS--------------------------------!!!-----LSSS-------------------------------
------------------------------XX----------------------------------------------------------------------------------------------------------------------
------------------------------XX--------------------------------------------------------------------------------------------g-------------------------
----------SSS-----------------XX-----------------------------------------------------------g--------------------------------#-------------------------
------------------g------SS---XX------------------------SU--!!!!-!!----------#-------------TT--------------@!!-----2-----#-##---------------TT--------
------------------TT----------XX--------g------------------------------------#-------------TT----------------------------#-##---------------TT--------
----M---------M---TT----------XX--------TT-----------------------------------##------------TT----------F-----------------####---------------TT--------
XXXXXXXXXXXXXXXXXXXT------k---XX--------TT--g--k----------------K--gg--------##---gg-------TT----------X------------kk---####--------gg-----TT--------
XXXXXXXXXXXXXXXXXXXXXXXXXXXXXXXXXXXXXXXXXXXXXXXXX---XXXXXXXXXXXXXXXXXXXXXXXXXXXXXXXXXXXXXXXXXX---XXXXXXXXXXXXXXXXXXXXXXXXXXXXXXXXXXXXXXXXXXXXXX---XXXX
