-------------------------------------------------------------------------------------------------------------X----------------------------------------
------------------------------------------------------------------------------------------------------------------------------------------------------
------------------------------------------------------------------------------------------------------------------------------------------------------
------------------------------------------------------------------------------------------------------------------------------------------------------
---------------------------------------------------------------------------S--------------------------------------------------------------------------
-----------------------------S-------------------------------------------S----------------------------------------------------------------------------
------------------------------------------@-----------------------------------------------!--------------------------g------!-------------S------!----
------------------@----------------------------------------------------@--------------------------------------------------------------------S---------
--------------------------------------1-----------------------------------------@---------!-----------------------------------------------------------
-----1------------------------------------------------------------------S----------------------------------1------------------------------------------
--------------------t------!-----S!---------!----S------------------------------!U------!---!---S---------------S------------!------tt-----S----------
--------------------tt!------------------------tt-tt-----------t------------------------------t--------------t----------------------tt@---------------
----------t---------tt-------------------------tt-tt-----------ttt----------------------------tt-------------t---t---------------ttttt-------------t--
-------g------------tt------------g--------g---tt-tt---------g-tttF-----------g---g-----------tt-------------t-g-t-------------g-ttttt-----------g-t--
XXXXXXXXXXXXXXXXXXXXXXXXXXXXXXXXXXXXXXXXXXXXXXXXXXXXXXXXXXXXXXXXXXXXXXXXXXXXXXXXXXXXXXXXXXXXXXXXXXXXXXXXXXXXXXXXXXXXXXXXXXXXXXXXXXXXXXXXXXXXXXXXXXXXXX
XXXXXXXXXXXXXXXXXXXXXXXXXXXXXXXXXXXXXXXXXXXXXXXXXXXXXXXXXXXXXXXXXXXXXXXXX-XXXXXXXXXXXXXXXXXXXXXXXXXXXXXXXXXXXXXXXXXXXXXXXXXXXXXXXXXXXXXXXXXXXXXXXXXXXX
