--------------------------------------------------------------------------------TT---------------------------------------------------------------TT---
------------------------------------------------------------------------------XXXXXX----TT-S-----------------------------S-!!!!------#-----C-----TT---
------------------------------------------------------------------------------XXXXXX----TT-------------------------------------------#-----------TT---
----------------------------------------------------------------------------------------TT------K----------K---------F---------------##----------TT---
----XX----------------------------------------------------------------------------------TT---------------------------X----------k----##---gg-g---TXXXX
----XX----------------------------------------------LSSS----------------------------XXXXXXXXXXXXXX---XXXXXXXX---XXXXXXXXXXXXXXXXXXXXXXXXXXXXXXXXXXXXXX
----XX-----------------!!!---------------------------------------------!!!--S-@-----XXXXXXXXXXXXXX---XXXXXXXX---XXXXXXXXXXXXXXXXXXXXXXXXXXXXXXXXXX----
----XX------------------------------------------------------------------------------------------------------------------------------------------------
----XX------------------------------------------------------------------------------------------------------------------------------------------------
----XX----------------------------------------------2-------------------------------------------------------------------------------------------------
----XX-----------------@!!--------g------#----------------------TT-----@!!!---------------------------------------------------------------------------
----XX----------------------------X------#----------------------TT------------------------------------------------------------------------------------
----XX----------------------------X--g---#---gg------kk---------TT------------------------------------------------------------------------------------
----XX--------k-------------k-----XXXXX--XXXXXXXXXXXXXXXXXX-----TT---------gkK----------------------------------------------SS--CSSS---------USSS-----
XXXXXXXXXXXXXXXX---XXXXXXXXXXXXXXXXXXXX--XXXXXXXXXXXXXXXXXXXXXXXXXXXXXXXXXXXXXX--TT------------------------------------------------S------------------
XXXXXXXXXXXXXXXX---XXXXXXXXXXXXXXXX-----------------------XXXXXXXXXXXXXXXXXXXXX--TT----------------------------------------------------------------T--
