------------------------------------X--XX-XXXXXXXXXXXXXX-XXXXXXXXXXXXXXXXXXXXXXXXXX--XXXXXXXXXXXXXXXXXXXXXXXXXXXXXXXXXXXXXXXXXXXXXXXXXXXXXXXXXXXX-----
------------------------------------------------------------------------------------------------------------------------------------------------------
------------------------------------------------------------------------------------------------------------------------------------------------------
------------------------------------------------------------------------------------------------------------------------------------------------------
-----------------------------------S------------------------------------------------------------------------------------------------------------------
---------------S--------------------------------------------------------------------------------------------------------------------------------------
------------------------S---S--------S---------S---------------S--------------@-------!----S----------------------------------------------------------
-----------------S-------------------------------------------S--S---------------------------------------SS----S---!-------X-S-------------------------
-----------------------------------------------------------!----------S-----------S-----S-----------!--------------S-S--------------------------------
----------------------------------------------S--------------!-------S-------------------------------S-C-----------S------------------S-------S-------
----------------!-S------------------------------------S--------------------------------------------!---S------S2-------------------------------------
--------!---S!--S-----------t----g----------S--S-C--T---------------#------------!-----------------L-----------------X--------t-----------t-------#---
----------------------T----------------------------tT---------------T--------------------T---------#---#-----------------------------------t-----Xt---
-------gg-----KT-------tX-Xk#t--g---g----g------T---T----------------#---------------------------------t-----------------t-----g-t-----#-------g#-----
XXXXXXXXXXXXXXXXXXXXXXXXXX-XXX-XXXXTXXXXX--g#------X--g-gt-------g--TT----t-----g----X-g--t------------g--------Tg--t----k----2------------------TTXXX
XXXXXXXXXXXXXXXXXXXXXXXX---XXXXXXXXXXXXXXXXXXXXXXXXXXXXXXXXXXXXXXXXXXXXXXXXXXXXXXXXXXXXXXXXXXXXXXXXXX-XXXXXXXXXXXXXXXXXXXXXXXXXXXXX-XXXXXXXXXXXXXXXXXX
