--------X-----t--#----X-----------------X--X-----------------k----------#--------------X-----X---X--------------X-S-X------------------X----X-XXr-----
-------X------------g---#----#X---S---XX---X--X#---X---------------X-----#--------------X-XX-T--------X--X------X-X-X--S-----SX---------X--X----#-X---
-----XXg----------------------X--X------X-------X---------------S------X--U--t-----X------------#2-X---#-T-X-------k---%X-------------@-#XX-2-------t-
--------------------yXF------X--X---------X-XX------X-----------X-X----g--X-------------------2-----X--XX-----------------!----T--!-----X-X--------X--
------X---#------X---X--X-X---t--------X----X----X----X----X-XX-X------XX-----------------X--XX--------XX---X--T--X----|---X-------#------X----------X
------------------------#-----------X--X-------X-------t------t--X-------X-------S-------------------------D----X------%-S-----X---X---------X#-------
-----------XX-X-----X-------S-U-X--X-X-----------------------------------#---X------T---X---X--X---X-X----#---------X------------------#--X-tS--------
------------------X--T-------X-------t-----------------------------X!-X-D-t----------2-X------X#-X-X---------X---------------X-----X---X-X------------
------------X-----XX-----------XX1---------------------XX--X-----------*-------------S---------X--------XX---S-------------------------!-X---XX--#XX--
------X--------------------X----X-!------X------#-X##----#--X--X-----X------XX-X-X--------------------------#---------GX-%-------------X#--------X----
-----X------X---X-----!-----X-----------X-----------M-------------------------------t------X#------X--X------X-X----!---X-X------S----X--X--------g---
---------!--X--X---------X-T-------X-X-X-----X------X------DX-----Xk------------XX--XX----T-------#-------------------------------M----------C------X-
-------C--------------G-X-------#-X----g---------------X---XD--#-----------------X--XUT-T--o-----------g-R-X-MX--#-------XX---XX--#S--X--X-X----------
----X-X----------X--#X-X------S-X------X------S---X--------X----X-----------%---------X--SX---X------XSX----------X--------X------X-----X---#------X--
XXXX-----------------T----T--------------------#----X--XX------------X--X----y-X--------#-1------XX--X----X---X----XX--X-XX--X----X-----#-1----XT----G
XXXX--------U-------X---------S---X-----X-X---------------------------X---DX---X----X-----X----*-------X-X---X------1----X------#X-------X------------
