------------------------------------------------------------------------------------------------------------------S---------S-------------S-------S---
------------------------------------------------------------------------------------------------------S------------------------------S----------------
-------------------------------------------------------------------------------------------S---S---SS----C--------------------------------------------
----------------------------------------------------------------------------------S------------------------S------------------S-----------------------
--------S---------------------------S----S--S----S---------------------S------------------------t--------------S----#----------S----------------------
------------------------S----------------------------------------S-------S-------S----------------!----------!--T-#-g##--------------k-----------#-T--
-------------------------------------S----------------------------------S-------------------t-------!--------------g#g-----t---------------L--T--g---k
---------!-----!-----------------------------------------------------------C-----!----------t---------t-----------C#####--#T-------T--t------X-XXXXXXX
----------------------------------S-------------------------------------#--------------T----------------------T---##g#----XX-XXX-XXgXXXXXXXXXXXXXXXXXX
----------#-----------------C-!---------S----t--------@------S-----------T----#------------------Xg---XXX-XXXXXXXXXXXXXXX-XXXXXXXXXXXXXXXXXXX---------
--------S---------##-------------t----------------------------------------t-----------g#---T##---XXXXXXXXXXXXXXX-XXXXXXX----------X-------------------
-----------------####--------------t-------------Tk--------------#-g-----T-#kXXXXXXXXXXXXXXXXXXXXXXX--------------------------------------------------
----------------#-##-----k--------g-------------T-----!kg--##---XXXXXXXXXXXXXXXXXXXXX--XX--XXX--------------------------------------------------------
-----------------##X#XXXXXXXXXXXXXXXXXXXXXXXXXXXXXXX--XXXXXXXXXXXXXXXXXXXXX---------------------------------------------------------------------------
XXXXXXXXXXXXXXXXXXXXXXXXXXXXXXXXXXXXXXXXXXXX--XXXXXXXXXXXXXXX---------------------------------------------------------------------------------S---S---
XXXXXXXX--XXXXXXXX----------------------------------------------------------------------------------------------------------------------------!-------
