---------#------X----X-X----X-------XX--#-X-----XX-----X---X--FX-X---T--X------X------X-------X----T----#--T------X-XX--X----------------X--#---X-----
----X-XXXXt--X---X--tX--------XS--X----X---X---X--X-XX---------X-----X--X!-----S--XX--X-------------X--X------g---#---------------X-X-X-----TX--X---XX
-------X--X---------X-Tt-#--------T--------X-X-T------XX--X--X-----------X-----X--X---X--X-----------X----X-X----X----XXX---t-Xg-----X-X--------XX----
-----------X--g--XXX-----@-X-------XX---X----X---X-#-------X-XX---X-X--------X-!-------X-X-----X-X-X---S----#-X---X-X-------X-----X----S-X------X---X#
---------------gX--S--XXX------X----------X--TX---#-----X------X--------X--X---------X--------X-----XX---X-----XXXX-XXX-SX------T-----------X-X---X--S
------X--X!-t---X---XXX--X-----X--X-X#-X-----------X--X-X--X--X-XX-X----X--X----X-------#----XTX-X-----X-------X--X------------------XX----X-X-----X--
-----X---------X--T------XX-----X---------#XX---X-------#----S--------X-X--!--X---X-U-XXS--------XX--SX------X----#-T---XX----X----------------t------
--------X--------X-------S--X-X-#XX-----------X-----------XX----XX-X----X-X-----XSX--X-X-X--X-------X----S--X---X-X---X---X------------ST-------X-----
--------!S----X---X------X----XXX-------------X-------X-----X--!X------S-X-X-T--K-X#---X-SX-XX-------X---X---------X---X-X---X------X-----X--X---XX---
--------XX-X--XX---------X-----X-S-X----S-X-X-M-----X-----X---------X----X--XX---X-----#---T-XX-X-X-X-----------XX----X--X---S--t-----X----X-X--X-X---
------#---X-----X----X---C--------X-XX!#-X-X-X#-X----S----------X----------------XX-----X-X-----------XX------X----------S-----X---XX------X---X---X-X
-----X-X--T--#-XSX--X-X------X-----X---X---X------XX---#X---X-----X--------X--------S----T--X----X--X-XX--X----X--X-------X-----X----X-g-g--X--X------
-------XX----X---------------------X---S--X----M----X----X-TX---X---------X-X-----XXX-XX----X------S--S---X-X#SX-tX-X-----t-----@---X-----------X--X-#
----T-T-XX---------X-X--X-----X---X--X---X------X---S---X--X---------X---X---XT-XT--X--X--XX-@---------X-----------T-----#--S------X--T-X----XX---XX--
XXXX---X----------X--X--X-g---t---S-X-X-#X---X------X---XX--X---------X--X-XX---X------X--X-----X----#--#----X-----!-----X-----XXX---X----XXTX-#--XXX-
XXXX--------#-----X-XX-------X#XT--T--------X---------#--X---!-#------TXXXX---X-----X----#X-SS-XX-XXX--------X----X----XX--XT-----XT--X-X----#X----X--
