-------------------------------------------X-------------------------------------XX-------------------------------------------------------------------
------------------------------------------------------------------------------------------------------------------------------------------------------
------------------------------------------------------------------------------------------------------------------------------------------------------
------------------------------------------------------------------------------------------------------------------------------------------------------
------------------------------------------------------------------------------------------------------------------------------------------------------
-------------------------------@--------------@------------------------------------------------!-----------------------------------S---S--------------
---------------------------S--S--------------------------------!--!------S@S-------!--------------S---S--------S-----------S--------S-----------------
----!----------------S------------------@-----------S--------------------------------------S------S------S-----S-------S-----------S------------------
-------!---------------------------------------------------------------------------------------------!-----S-S----------------------!-----------------
-----S------------!---!--------------------X---U------T----------------------!------------------g--------------------------------!--------------------
----------------------S-------t----------------------t-t---------------------------------T-------------k-----!-------------!------------@-------------
-------------------------------------------!------------------------------------------------!--X-----@------T--t-!---------------------t---------g----
----t----------t-------------!-T-------------t-----t#-M#-g---------------------------------t---------------------------------------------T-S----------
---------T-X----#------------g-gk--k#--------X----g--TT#X-----F---t-------------------------g--T--------t---------------k---g-----Ft---g--------t----g
XXXXXXXXXXXXXXXXXXXXXXXXXXXXXXXXXXXXXXXXXXXXXXXXXXXXXXXXXXXXXXXXXXX#XXX-XXXXXXXXXXXXXXXXXXXXXXX-XXXX-XXXXXXXXXXXXXXXXXXXXXXXXXXXXXXXXXXXXXXXXg-XXXXXXX
XXXXXXXXXXX-XXXXXXXXXXXX--XXX-XXXXXXXXXXXXXXXXXXXXXXXXXXXX-XXXXXXXXXXXXX-XXXX--XXXXXXXXXXXXXXXXXXXXXXXXXXX-XXXXXXXXXXXXXXXXXXXXXXXXXXXXXXXXXXXXXXXXXXX
