-----X------Y-2-X----X-S-------tXXM----o--------r-1-Xk----X-1---|-2----Y--X------X------FX-----------X---2X-------X-y----X--Y-#-o----2-tF-----------r-
-----X----XX----!XXX--X-X#--t-----X--RX---X-XGo-----%SSX-----C-----X---X----T---X---X---------t----------X----@----D--y---X#-#g--X----X-X-*----------#
-----X---XX-----X-----------U#---------------X----------X-g#X---1----y1----------------------%---------M-----------X----X------------X-X-X------S-X--o
-----X----------------#-S-------Xo-X#-C-X|-r-U-XX-----------@---------------------X---X----X----------X#X--X----X---*-L---------D--TY--RX-----X-----X-
----------------o--------X-X-X-M---Xr-X----XX-X----KM-L----S-X-----LX-XX---X--X----------o-----------------------X--X---------T--S------#y----------X-
--------X---------X------X-o---Xg---X-X---X------X-U-X----X-XR------X---X--------XX----k---X----X---------D--X-------2--X---------------------1X-g-*X-
----------G---X--------------X--------M------------------X------X----------o---r-X-*XX-X----1----------------------o-X------o-----------M-X-M---X----X
------------------M-o---XX-X--#-X-----K-----------X-X---S-X--S-X-L----X--X--K---X----X---XX----X--C--K--XX-----#----X--|X---2--X---X------X--------X--
-------------------g----XX---2-S---Xy---o--X------X-X---r-X------!--tk-M----X-------XX-----U-Y--#X----11--2-----k----XX-X-----X-------------X-X--Xt---
--------t---X--G---%-X-------X-U-XX-SX-----X------t---------C-XX-X-----X---------LX---X---Y-----X-R--X---------X-------X-XX------------SD-----X---2---
----!------------D-----XL-------X-XX---------1-------1--CX--X----X------L-X--L------2---------------r-M--X------------X--------L---------------X---R--
-----------r--X------------#--@--------X-----U------X-D------------XX-------X--X--XXX------------------X--------C---M---X-%-------1--o--------X-X-----
----------X-------------X--------r--K-------X---------------------t------------------C----X--YX------X-X---g------X-L------S--X-D----X--X-----X-r---Y-
----k-Xk-#--L---------------X-------------X--------X-------X1---X----X-2-@---o--------2------------1----------------1-----o----Xr-X-X-----------------
XXXX----------X-|---C--SX-------C-------r---------LF--X-L------X#--------|--S--#------XX--X-X--X----XX-S-X--X-X--------X--MXXXL-----------------------
XXXX-X-----X--X-------X----X-------%-X-KX--DX---C---------------X--@--------r-------#-----#--X-------------!-X--X-#---X-X------F-g------X--X--X---X--X
