-----tXT----X----------XX--------#----XX--X------X-X--XX--S----X-#---#----X--X--XX--------XX----------X---%-----------#-------X-X-#---X-------------U-
-------XX#------gS-----X-X#-X---------X---X-X-------X--------------D------S-XX-X-@----%-----------------X---#--------%---------X------tX----S---------
--------Xg---XG-X--X------------X--------X--k#--------------tK---X--#------Y#-X--o----X--X----------X---X---X----S-------------!-M--XX-g--------------
-----#-----------X-X#------------------X-X--X----#-XX--X-t---------------t----------X--------------------X-----------------g-----------X----XX-----y#-
----k--------X------C---%----L-------!X-----X---------X-----------X-X--XX------------S--X---X-------t--------X---X-----X--t----XX------X-----X--------
---------X---------#X---------R-----X-#-----------------X--X--X---------X--#-------------#--X--------K-----X------X--X--------X-------------t%--------
-----------X---------------#XX-X---------------X----2---X--X--#---------X------K------X-------X----XoX-----XS------------L----------X--X---------%----
-----X--------X@------tk---------------------------#----X-----X-X-X---X--X---#-----t---------X----X-------------X------X-X-oX-----------X---X-X---XX-#
-------X-----X-----------------------X----X----X--X--XX----#-X--------X----X---X-------X----X--------T-X-#---T-#-------X----XX--X-------X#------------
----X-----------------------S-----X------#X-X-------------#-----X-------X--X------Xt------g---U#-GX--------X----X---X--------X---------X----X-------X-
----------------X-----------1-----------X------------X-----------G----#----------#X-----XX---g-T--------#---------S-----X-X---r-------X--------------X
------X---X--X-----S-oX--#---------------X------X------------------X-X-----X---X-SX---X-----X-XX-------------XX-----------gX---X!X------X---------SXX#
------------X---X-XX----X------X---X-X---!-------X---------X--D----------------X---------------#----!-----X-XL-----#-------X---X---------X------X---X-
-------G!T-------X-X----X--------XX------X---X-----------------------R--X----*--XX-X-------!----------T----g-X-LX-----X---------X----X-S--X-!@#X---X--
XXXXX------M----------XXX------#-t-X-t----XX--X-----X---S--------X-X-----#X---------yXX--X-----#------------XX-------X----X-X--X---------------X--X-t-
XXXXX--------GX-X-----X-XX-----T----X-X-X-----X---------------------S-X------T----G--X--------XX---X-----X----@-----GXX-X--------------------X---X-%X-
