--------------------------XXXXXXXXXXXXXXXXXXXXXXXXXXXXXXXXXXXXXXXXXXXXXXXXXXXXXXXXXXXXXXXX--XXXXXXXXXXXXXXX---XXXXXXXXXXXXXXXXXXXXXXXXXXXXXXXXXXXXXXXXXXXXXXXXXXXXXXXXXXXXXXXXXXXXXXXXXXXXXXXXXXX-XXXXXXXXXXXXXXXXXXXXXXXXXXXXXXXXXXXXXXXXXXXXXXXXXXXXXXXXXX---XXXXXXXXXXXXXXXXXXXXXXXXXXXX-
--------------------------------------------------------------------------------------------------------------------------------------------------------------------------------------------------------------------------------------------------------------------------------------------
--------------------------------------------------------------------------------------------------------------------------------------------------------------------------------------------------------------------------------------------------------------------------------------------
--------------------------------------------------------------------------------------------------------------------------------------------------------------------------------------------------------------------------------------------------------------------------------------------
--------------------------------------------------------------------------------------------------------------------------------------------------------------------------------------------------------------------------------------------------------------------------------------------
--------------------------------------------------------------------------------------------------------------------------------------------------------------------------------------------------------------------------------------------------------------------------------------------
--------------------------------------------------------------------------------------------------------g-----------------------------------------------------------------------------------------------------------oo----------------------------------------------------------------------
--------------------------------------------!---------------------------------------------------------SSSSSSSS---SSS!--------------@-------------------------------------------##----USSS------------------------------------------------------SSS-------------------------------##---------
--------------------------T----------------------------------------------------------------------------------------------------------------------------------------------------##-----------------------------------------------------------------------------------------------###---------
--------------------------T--------------------------------------------------------------------------g-------------------------------------------------------------------------##----------------------------------------------------------------------------------------------####---------
--------------------------------------------------------------------------------------1---------------------------------------------------------------------------------K---#--##-------------------------------------------------------------------------g-------------------#####---------
-------K------------------------------!---S@S!S---------------------tt---------tt------------------S@S--------------C-----SU----!--!--!------------------------------------##--##-----------#------------------TT--------------------TT--------SSS--------TT-----------------######---------
------------------------------------------------------------tt------tt---------tt------------------------------------------------------------------------------TT---------###--##-----tt----#------TT----------TT--------------------TT-------------------TT----------g------######---------
--M-----------ggg---------k-----------------------tt--------tt------tt---------tt--------------------------------------------------------------TT---------B----TT--------####---------tt----#------TT----------TT---------tt---------TT-------------------TT----------TT---########--------F
XXXXXXXXXXXXXXXXXXXXXXXXXXXM---------------g------tt--------tt-g----tt-----g-g-tt------------------------------------g-g--------k--------------TT---------b----TT--k----#####---------tt----#------TT------y---TT---ggg---tt-k---ggg-TT----k--------------TT----------TT--g########--------#
XXXXXXXXXXXXXXXXXXXXXXXXXXXXXXXXXXXXXXXXXXXXXXXXXXXXXXXXXXXXXXXXXXXXXXXXXXXXXXXXXXXXXXXXXXX--XXXXXXXXXXXXXXX---XXXXXXXXXXXXXXXXXXXXXXXXXXXXXXXXXXXXXXXXXXXXXXXXXXXXXXXXXXXXXXXXXXXXXXXXXXXXXXXXXXX-XXXXXXXXXXXXXXXXXXXXXXXXXXXXXXXXXXXXXXXXXXXXXXXXXXXXXXXXXX---XXXXXXXXXXXXXXXXXXXXXXXXXXXX
