------------------------------------------------------------------------------------------------------------------------------------------------------------------------------------------------------------------------------------------------------------------XXXXXXXXXXXXXXXXXXXXXXXXXXX-X-XX-X-XX-XXXXXXXXXXXXXXXXX-X-X-XXXXXXXXXXXXXXXXX------XXXXXXXXXX-XX--XX--XXXXXXXXXXXXXXXXXXXXXXXXXXXXXXXXXXXXXXXX
----------------------------------------------------------------------------------------------------------------------------------------------------------------------------------------------------------------------------------------------------------------------------------------------------------------------------------------------------------------------------------------------------------------
----------------------------------------------------------------------------------------------------------------------------------------------------------------------------------------------------------------------------------------------------------------------------------------------------------------------------------------------------------------------------------------------------------------
----------------------------------------------------------------------------------------------------------------------------------------------------------------------------------------------------------------------------------------------------------------------------------------------------------------------------------------------------------------------------------------------------------------
----------------------------------------------------------------------------------------------------------------------------------------------------------------------------------------------------------------------------------------------------------------------------------------------------------------------------------------------------------------------------------------------------------------
----------------------------------------------------------------------------------------------------------------------------------------------------------------------------------------------------------------------------------------------------------------------------------------------------------------------------------------------------------------------------------------------------------------
-----------------------------------------------------------------------SS----------------------------------SSSSCSSS---------------------------------------------------------------------------------------------------------------------------------------------------------------------------------------------------------------------------------------------------------------------------------------------
-------------------------------------------------------------------------------------------------------------------------------------------------------------------------------------------------------------------------------------------------------------------------------SSSSCSSS-------------------------------------------------------------------------------------------------------------------------
--------------------------------------------------------------------------------------o-------------------------------------------------------------#-------------------------------------------------------------------------------------------#---------------------------------------------------------------------------------------------------------------------------------------------------------------
------------------------------oo-------------------------------------------------g-----------------------------------------------------------------##--oo------o----o-------------------oo--------------------tt-------------------------------##--oo------o-----------------------------------------------------------------------------------------------------------------------------------------------#----
-------------------------------------------------TT--#-----------------SSCS------TT-----------------------#----2----#-----------------------------###-----------------------------------------------------TT--tt------------------------------###---------------oo-------------------------------------------SSUSSSSS-----------------------------oo---------------------tt-------------------------------##--oo
-------K-------------------------------------TT--TT--##--------------------K-----TT-----------------------#------K--#------tt--------------------####-------------------------------------------------TT--TT--tt-----------------------------####-----------------------------#----2----#----------------------------------------------------------------------------TT--tt------------------------------###----
-----------------#---------------------------TT--TT--##----#---------------------TT-----------#-----------#---------##-----tt-------------------#####----------------------#---#----------------------TT--TT--tt----------------------------#####-----------------------------#------K--#-------K----------------------------------------------------------------TT--TT--tt-----------------------------####----
--M------------kk#----------------------ggg--TT--TT--##------gg--k------K--------TT------------------ggg--#---------##-----tt-------ggg------gg######--k-------------------#-k-#-----------------ggg--TT--TT--tt-----k--ggg-----ggg------gg######--k--------------------------#---------#-----------K----------------------------------#-------------------------TT--TT--tt----------------------------#####----
XXXXXXXXXXXXXXXXXXXXXXXXXXXX------XXXXXXXXXX-XX--XX--XXXXXXXXXXXXXXXXXXXXXXXXXXXXXXX----XXXXXXXXXXXXXXXXXXXXXXXXXXXXXXXXXXXXXXXXXXXXXXXXXXXXXXXXXXXXXXXXXXXXXX---XX---XXXXXXXXXXXXXXXX-----XXXXXXXXXX-XX--XX--XXXXXXXXXXXXXXXXXXXXXXXXXXXXXXXXXXXXXXXXXXXX---XX----------ggg--#---------#--------------------------------------------kk#--------------------ggg--TT--TT--tt-----k--ggg-----ggg------gg######--k-
XXXXXXXXXXXXXXXXXXXXXXXXXXXX------XXXXXXXXXX-XX--XX--XXXXXXXXXXXXXXXXXXXXXXXXXXXXXXX----XXXXXXXXXXXXXXXXXXXXXXXXXXXXXXXXXXXXXXXXXXXXXXXXXXXXXXXXXXXXXXXXXXXXXX---XX---XXXXXXXXXXXXXXXX-----XXXXXXXXXX-XX--XX--XXXXXXXXXXXXXXXXXXXXXXXXXXXXXXXXXXXXXXXXXXXX---XX----XXXXXXXXXXXXXXXXXXXXXXXXXXX-X-XX-X-XX-XXXXXXXXXXXXXXXXX-X-X-XXXXXXXXXXXXXXXXX------XXXXXXXXXX-XX--XX--XXXXXXXXXXXXXXXXXXXXXXXXXXXXXXXXXXXXXXX
