------------------------------------------------------------------------------------------------------------------------------------------------------------------------------------------------------------
------------------------------------------------------------------------------------------------------------------------------------------------------------------------------------------------------------
------------------------------------------------------------------------------------------------------------------------------------------------------------------------------------------------------------
---------------------------------------------------------------------------------------------------------SSSSSSSSSSSSSSSSSSSSSSSSSSSSSSSLSSSSSSSSSSSSSSSSSSSSSSSSSSSSSSSSSSSSSSSSSSSSSSSS-------------------
-----------------------------------------------------------------------------------------------------------SSSS--SSSS------SSSS-----------------------------------------------------------------------------
-----------------------------------------------------------------------------------------------------------SSSS--SSSS---g--SSSS-----------------------------------------------------------------------------
-------------------------------------------------------------------------SS!SSS@SSS--------SSC-----------So--SS---S----SS----------oooooo--------------------------------------------------SSS--------------
-------------------------------------------------------------------------------------------------------------SS---S----SS-----------------------------------------------------------------------------------
------------------------------------------------------------------------------------------------------#---S--SS---S----SS----------SSSSSS-------------------------------------------------------------------
---------------------------------------------------------------------------K---------------SSS-------g#---SooSS---SoU--SC--g-g-----SSSSSS-------------------------------------------------------SSSSSSU-----
-----------------------------------------------------------------TT------SSSSSSSSSSS-----------------##--SSSSSS---SSS--SS--SSSS-----------------------------TT------------------------g##-------------------
-------K--------------------TT-----TT----K-----------------------TT---------------------------------###-----------------------------------------------TT----TT-----------SS-----------###-------------------
----------------------------TT-----TT----------------------------TT--------------------------------####-----------------------------------------------TT----TT----TT-----SS---------g####--SSS--------------
--M-----------ggg---------kkTT-----TT-----------ggg-------ggg----TT--------------K----------------#####-------g-g------------------------------g-g-g--TT----TT--g-TT-----SS---------#####---------r--------F
XXXXXXXXXXXXXXXXXXXXXXXXXXXXXXXXX--XXXXXXXXXXXXXXXXXXXXXXXXXXXXXXXXXXXXXXXXXXXXXXXXXXXXXXX----XXXXXXXXX--XXXXXXXXXXXXXXXXXXXXXX---XXXXXXXXXXXXXXXXXXXXXXXXXXXXXXXXXXXXX--XX--XXXXXXXXXXXX-------XXXXXXXX--XX
XXXXXXXXXXXXXXXXXXXXXXXXXXXXXXXXX--XXXXXXXXXXXXXXXXXXXXXXXXXXXXXXXXXXXXXXXXXXXXXXXXXXXXXXX----XXXXXXXXX--XXXXXXXXXXXXXXXXXXXXXX---XXXXXXXXXXXXXXXXXXXXXXXXXXXXXXXXXXXXX--XX--XXXXXXXXXXXX-------XXXXXXXX--XX
