---------------------------------------------------------------------------------------------------------------------------------------
---------------------------------------------------------------------------------------------------------------------------------------
---------------------------------------------------------------------------------------------------------------------------------------
---------------------------------------------------------------------------------------------------------------------------------------
----------------------------------------------------------------------------------------------------------------------------XX---------
----------------------------------------------------------------------------------------------------------------------------XX---------
---------------------------------------SS!SSS@S----1---------------------------------------------SSSSCS---@-------------C---XX---------
----------------------------------------------------------------------------------------------------------------------------XX---------
----------------------------------------------------------------------------------------------------------------------------XX---------
-----------------------------------------K--------------------1--------o----------------------------------------------------XX---------
-------------------------------TT------SSSSSSSS-----------TT----------------------------------C---------!--------------SS---XX---------
-------K-----------------------TT------------------TT-----TT----TT--------K----------#------------------------TT------------XX---------
-------------------------------TT------------------TT-----TT----TT---------------K---#------------------------TT------------XX--------F
--M-----------ggg-------ggg----TT------------------TT-----TT---kTT-------------------#-------gg--------K-K----TT--------k---XX--------X
XXXXXXXXXXXXXXXXXXXXXXXXXXXXXXXXXXXXXXXXXXXXXXXXXXXXXXXXXXXXXXXXXXXXXXXXXXXXXXXXXXX--XXXXXXXXXXXXXXXXXXXXXXXXXXXXXXXXXXXXXXXXXXXXXXXXXX
XXXXXXXXXXXXXXXXXXXXXXXXXXXXXXXXXXXXXXXXXXXXXXXXXXXXXXXXXXXXXXXXXXXXXXXXXXXXXXXXXXX--XXXXXXXXXXXXXXXXXXXXXXXXXXXXXXXXXXXXXXXXXXXXXXXXXX
