------------------------------------------------------------------------------------------------------XXXXXXXXXXXXXXXXXXXXXXXXXXXXXXXXXXXXXXXXXXXXXXXXXXXXXXXXXXXXXXXXXXXXXXXXXXXXXXXXXXXXXXXX----XXXXXXXXXX---XXXXXXXXXXXXXXXXXXXXXXXXXXXXXXXXXXXXXXXXX-XXXXXXXXXXXXXXXXXXXXXXXXXXX-
-------------------------------------------------------------------------------------------------------------------------------------------------------------------------------------------------------------------------------------------------------------------------------------
-------------------------------------------------------------------------------------------------------------------------------------------------------------------------------------------------------------------------------------------------------------------------------------
-------------------------------------------------------------------------------------------------------------------------------------------------------------------------------------------------------------------------------------------------------------------------------------
--------------------------------------------------------------------------------------------------------------------------------------------------------------------------------------------------------------------------------------------------------U----------------------------
-------------------------------------------------------------------------------------------------------------------------------------------------------------------------------------------------------------------------------------------------------------------------------------
------------------------------------------SUS-----------------------------------------------------------------------------------------------------------------------------------------------------------------------------------------------------------------------------k----------
-------------------------------------------------------------------------------------------------------------------------------LSSS---------------------!!!!!-----------USSS--------SSCSS------SSSS------------------------------------SSSSS------------------------------##---------
----------------------------------------------------------------------------------------------------------------------------------------------------------------------------------------------------------------------------------------------------------SS-------------###---------
------------------------------------------------------------------------------------------------------k--------------------g-----------------------------------------------------------------------------------------------------------------------------------#--------####---------
-----------------------------------------#####-----------------------------------------------------#LSS--------------------#------------------------------k-----------------------------------------------g-----------------------------K-------------SS------##-------#####---------
-------K---------------------------------#--------------------------#------------------------------#---------------SS-----##---2-----#-----------TT-----@!!!!----------S-----TT---!!!!--!!!---------------TT---------------------------SSSSS-----------------###------######---------
----------------------------------------K#---------------------*----#------------------------------#-----B---------------###---------#-----------TT--------------------------TT---------------------------TT----------g-------------------K---#----B--------####-----#######---------
--M-----------ggg-------ggg--------------#--------------ggg----*----#----ggg--k----ggg-----------kk#-----b--------------####---------##----------TT--------------------------TT---------------------------TT----------TT------k--TT-----------#----b-------#####----########--------F
XXXXXXXXXXXXXXXXXXXXXXXXXXXXXXXXXXXXXXXXXXXX----XXXXXXXXXXXXXXXXXX--XXXXXXXXXXXXXXXXXXXXXXXXXXXXXXXXXXX--bT----k-------#####----kk---##---gg-----TT------------gg----k-ggg---TT------------ggg------------TT----------TT--g---#--TT-----------#----B------######---#########--------#
XXXXXXXXXXXXXXXXXXXXXXXXXXXXXXXXXXXXXXXXXXXX----XXXXXXXXXXXXXXXXXX--XXXXXXXXXXXXXXXXXXXXXXXXXXXXXXXXXXXXXXXXXXXXXXXXXXXXXXXXXXXXXXXXXXXXXXXXXXXXXXXXXXXXXXXXXXXXXXXXXXXXXXXXXXXXXXXXXXXXXXXXXXX----XXXXXXXXXX---XXXXXXXXXXXXXXXXXXXXXXXXXXXXXXXXXXXXXXXXX-XXXXXXXXXXXXXXXXXXXXXXXXXXX
