----------------------------------------------------------
----------------------------------------------------------
----------------------------------------------------------
----------------------------------------------------------
----------------------------------------------------------
----------------------------------------------------------
----------------------------------------------------------
----------------------------------------------------------
----------------------------------------------------------
----------------------------------------------------------
-----------------------------------------SS!S-------------
-------K--------------------TT-----TT---------------TT----
----------------------------TT-----TT---------------TT---F
--M-----------ggg---------kkTT-----TT----------gg---TT---X
XXXXXXXXXXXXXXXXXXXXXXXXXXXXXXXXX--XXXXXXXXXXXXXXXXXXXXXXX
XXXXXXXXXXXXXXXXXXXXXXXXXXXXXXXXX--XXXXXXXXXXXXXXXXXXXXXXX
