----X---g------------------------------X-XX----X------------------------------S-----------------------------------------------------------------------
------------------------------------------------------------------------------------------------------------------------------------------------------
------------------------------------------------------------------------------------------------------------------------------------------------------
---------------------------------------------------------------------------------------------------@--------------------------------------------------
------------------------------------------------------------------------------------------------------------------------------------------------------
----------------------------------------------------------------------------S--!----------------S--------------S---------------------------------S----
-----------------------------------------------------------------------------------------------SSSS----------------------------------------SS---------
------------------------------------------------------------------------------------S-------------S-------S-------------------------------------S-----
--------S------------------------------t-----------------------------------S------------------S-----------------------------S-------------------------
----------S-----------------------------#-------------------------------------------S-----t-----------------------------------------------------------
-------------------#--##------------#--##------------t--------t------t-------------------tt-t--------------------------------------t-----t------------
----------S-------##--###--------####t-###----------------------t---t-tt---------t---g--Ct-----g----------t-----------------g----------------------g--
------------k--t####--##t-#-----#-###--####-------------t----!|t-----Y-tt-----------1--g-#2--M------------t----------------t------t--g-XXX--g----g--g-
------------S----###X-####-#-----#t###-####----#t--XXXXXXXXXXXXXXXXXXXXXXXXXXXUXXXXXXXXXXXXXXX-XXXX-XXXXXXXX--Xg-XXXXXXXXXXXXXXXXXXXXXXXXXX-XXXXXXXXXX
XXXXXXXXXXXXXXXXXXXX--XXXXXXXXXXXXXX---##XXX-XXXXXXXXXXXXXXXXX-XXXXXXXXXXXXXX-XXXXXXXXXXXXXXX-X----XX-XXXXXXXXXXXXXXXXXXXXXXXXXXXXXXXXXX------X-XXXXXX
XXXXXXXXX-XXXXXXXXX--XX-XXXXXXXXXXXXX--XXXXXXXXXXXX-XX----------------------------------X------------X---------XXXXX------X-----X-------------------X-
