---------#---X---------#-X---X-----S-X--%-----%T--%-X--------S-----X--|X---X#--XS---XS------X----S-X-X-X-------------X----------S-----X-----S--T----X-
-------S------S-----%----------X--XX-----X----X--------X-------X-S---X|-X--------X-X--X---XX%----S-S-X#-X---------SS---------S-S---------X----X-%--X--
---------------T-----%-#--#---------T-%-------T-------XXX-----------X-----X-SX--X-X-g--g-------------g------X--S-#------X------------SX-X---X-X--X-X--
--------X--X---X-X---X----------X-----S------S----------XX-S-SSg-X-S------X----|------X---X-----%X-X-----------X------------X--XS-S----SX------X-X--X-
----|-----#--SS--------------X#-X-----S----------------%XS-----XX-#--T----X---S-X------#-X-X--TS--X----X---X---o-#--T--%--|T----X---X----X---o--X----X
----T----S--X--X------T-oX-----------o---S----X-X-----------X-#--------------X---S---SX#-Xo--X-T-X-----S-------X--#------g--#X-------T-X------S-#-S-X-
----o---X-t--|-X---o----X----------------------------X-#----------S--------X--S--XX--S------XX---X---XX------S--XX---X--X---T--------S-SX--X#-X----X-X
-----o-o----------X------S-------T-S------S|X-----X---S-SXX-------X-----------S---------X--XX---X-oSX-TT--X--#S-X-X-------t--XX---S---X------S----S--S
----------XS-----X------g--X-|XXSXSgX----S---------X-X-%----TS------S-----------------XX-------X-X--------|-SX----------------T------------X---S---S-|
--------X---X---X-----S-----X---------o------#X--X----S-gSX-SX-----XX--|-----------SXX-SX---S----X-X--g-S--X--gX%----S----X--X-X---------X----X---X---
-----------------S--XX%--------S-S--SXX----X-----S----------------S---XT--------#XgX-----X--------X#-S-----XS-X----X-%----#--X------T-X-T------X------
-------TS---------%#--S-X--X%--S-S------X-------SX-XX---ST---------XXX------T------X--------S-------#--T--t-----X-X--X---o---X-------X-------T--S----T
----X----X#-----%-----S-------X--S-----T-#---S----------X-XS--X-X--S-%-S-----X--X-----#-----X---S-----S----T---S---------X----X--X-----X--T-----------
--------S---------------X|X-X---%------S-----X-X-S-|----X----TX---S-----T------%X--------X--#------|X----TX------X---S-------S-k----X------X-------XX-
XXXX--X----S-||------X--X-------X-#---|XXX---------S--X---------X--|S------#----XX-------S-tS-------------X--X---X-------S---XX--------g--S----S---R--
XXXXXX--X--%XX----------X-XS--------|X--t---|---%X---X-X-----------XX--X-----------X--X-------S-S%------------S--X--#-X-------X---#---------S------XS-
