------------------------------------------------------------------------------------------------------------------------------------------------------
------------------------------------------------------------------------------------------------------------------------------------------------------
------------------------------------------------------------------------------------------------------------------------------------------------------
------------------------------------------------------------------------------------------------------------------------------------------------------
------------------------------------------------------------------------------------------------------------------------------------------------------
------------------------------------------------------------------------------------------------------------------------------------------------------
----------------------------------------SUS------------------------------------------------------------------------------------------------##---------
-------------------------------------------------------------------------------------------------------------------------------------------##---------
----------------------------------------------------------------------------------------------------------TT-------------------------------##---------
----------------------------------------------------------------------------------------------------------TT------------------------K---#--##---------
---------------------------------------#####-----------------------------------------------------#LSS-----##---------------------------##--##---------
-------K-------------------------------#--------------------------#------------------------------#------------------------------------###--##---------
--------------------------------------K#---------------------*----#------------------------------#-----------*---TT-----*------------####------------F
--M-----------ggg-------ggg------------#--------------ggg----*----#----ggg--k----ggg-----------kk#-----------*---TT-----*-----K-----#####------------#
XXXXXXXXXXXXXXXXXXXXXXXXXXXXXXXXXXXXXXXXXX----XXXXXXXXXXXXXXXXXX--XXXXXXXXXXXXXXXXXXXXXXXXXXXXXXXXXXXX---XXXXXXXXXXXXXXXXXXXXXXXXXXXXXXXXXXXXXXXXXXXXX
XXXXXXXXXXXXXXXXXXXXXXXXXXXXXXXXXXXXXXXXXX----XXXXXXXXXXXXXXXXXX--XXXXXXXXXXXXXXXXXXXXXXXXXXXXXXXXXXXX---XXXXXXXXXXXXXXXXXXXXXXXXXXXXXXXXXXXXXXXXXXXXX
