--------------------------------XXXXXXXXXXXXXXXXXXXXXXXXXXXXXXXXXXXXXXXXXXXXXXXXXXXXXXXXXXXX--XXXXXXXXXXXXXXXXXXXXXXXXXXXXXXXXXX-
---------------------------------------------------------------------------------------------------------------------------------
---------------------------------------------------------------------------------------------------------------------------------
---------------------------------------------------------------------------------------------------------------------------------
---------------------------------------------------------------------------------------------------------------------------------
---------------------------------------------------------------------------------------------------------------------------------
----------------------------------------------------------------------------------------------------------------------y----------
----------------------------------------------!-----------------------------------------------------------------------##---------
--------------------------------------------------------------------------------------------------------------------y###---------
-----------------------------oo-------------------------------------------------------------------------------------####---------
----------------------------------------------------------------------------------------1--------------------------#####---------
-------K------------------------------------S@S!S---------------------tt---------tt-------------------------------######---C-----
---------------#----------------------------------------------tt------tt---------tt------------------------------#######---------
--M----------kk#------------------------------------tt--------tt------tt---------tt-----------------------------########--------F
XXXXXXXXXXXXXXXXXXXXXXXXXXX-----X------y-----g------tt--------tt-g----tt-----g-g-tt--------------y--y----------#########--------#
XXXXXXXXXXXXXXXXXXXXXXXXXXX-----XXXXXXXXXXXXXXXXXXXXXXXXXXXXXXXXXXXXXXXXXXXXXXXXXXXXXXXXXXXXX--XXXXXXXXXXXXXXXXXXXXXXXXXXXXXXXXXX
