------------------------------------------------------------------------------------------------------------------------------------------------------------------------------------------
------------------------------------------------------------------------------------------------------------------------------------------------------------------------------------------
------------------------------------------------------------------------------------------------------------------------------------------------------------------------------------------
------------------------------------------------------------------------------------------------------------------------------------------------------------------------------------------
------------------------------------------------------------------------------------------------------------------------------------------------------------------------------------------
------------------------------------------------------------------------------------------------------------------------------------------------------------------------------------------
-------------------------------------------------------------------------------------------------------------------------------------------------------------------------------##---------
-------------------------------------------------------------------------------------------------------------------------------------------------------------------------------##---------
--------------------------------------------------------------------------------------#--------------------------------------------------------------------------------------#-##---------
-----------------------------oo---------------------tt-------------------------------##--oo------o----o-------------------oo---oo--------------------------------------------#-##---------
------------------------------------------------TT--tt------------------------------###------------------------------------------------------------------------------------#-#-##---------
-------K------------------------------------TT--TT--tt-----------------------------####-----------------------------------------------------------------TT-----------------#-#-##---------
---------------#----------------------------TT--TT--tt----------------------------#####----------------------#---#--------------------------------------TT----------TT---#-#-#-##--------F
--M----------kk#-----------------------ggg--TT--TT--tt-----k--ggg-----ggg------gg######--k-------------------#-k-#-----------------------k------kkk-----TT----------TT---#-#-#-##--------#
XXXXXXXXXXXXXXXXXXXXXXXXXXX------XXXXXXXXXX-XX--XX--XXXXXXXXXXXXXXXXXXXXXXXXXXXXXXXXXXXXXXXXXXXX---XX---XXXXXXXXXXXXXXXX-----X----XXXXXXXXXXXXXXXXXXXXXXXXXXXXXXXXXXXXXX-X-X-X-XXXXXXXXXXX
XXXXXXXXXXXXXXXXXXXXXXXXXXX------XXXXXXXXXX-XX--XX--XXXXXXXXXXXXXXXXXXXXXXXXXXXXXXXXXXXXXXXXXXXX---XX---XXXXXXXXXXXXXXXX-----X----XXXXXXXXXXXXXXXXXXXXXXXXXXXXXXXXXXXXXX-X-X-X-XXXXXXXXXXX
