----------------------------------------------------------------------------------------------------------------------------------------------------------------------------------------
----------------------------------------------------------------------------------------------------------------------------------------------------------------------------------------
----------------------------------------------------------------------------------------------------------------------------------------------------------------------------------------
----------------------------------------------------------------------------------------------------------------------------------------------------------------------------------------
----------------------------------------------------------------------------------------------------------------------------------------------------------------------------------------
----------------------------------------------------------------------------------------------------------------------------------------------------------------------------------------
-----------------------------------------------------------------------------------------------------------------------------------------------------------------------------##---------
-----------------------------------------------------------------------------------------------------------------------------------------------------------------------------##---------
---------------------------------------------------------------------------------------#-----------------------------------------------------------------------------------#-##---------
------------------------------oo---------------------tt-------------------------------##--oo------o----o-------------------oo---oo-----------------------------------------#-##---------
-------------------------------------------------TT--tt------------------------------###---------------------------------------------------------------------------------#-#-##---------
-------K-------------------------------------TT--TT--tt-----------------------------####---------------------------------------------------------------TT----------------#-#-##---------
-----------------#---------------------------TT--TT--tt----------------------------#####----------------------#---#------------------------------------TT---------TT---#-#-#-##--------F
--M------------kk#----------------------ggg--TT--TT--tt-----k--ggg-----ggg------gg######--k-------------------#-k-#-----------------------k------kkk---TT---------TT---#-#-#-##--------#
XXXXXXXXXXXXXXXXXXXXXXXXXXXX------XXXXXXXXXX-XX--XX--XXXXXXXXXXXXXXXXXXXXXXXXXXXXXXXXXXXXXXXXXXXX---XX---XXXXXXXXXXXXXXXX-----X----XXXXXXXXXXXXXXXXXXXXXXXXXXXXXXXXXXX-X-X-X-XXXXXXXXXXX
XXXXXXXXXXXXXXXXXXXXXXXXXXXX------XXXXXXXXXX-XX--XX--XXXXXXXXXXXXXXXXXXXXXXXXXXXXXXXXXXXXXXXXXXXX---XX---XXXXXXXXXXXXXXXX-----X----XXXXXXXXXXXXXXXXXXXXXXXXXXXXXXXXXXX-X-X-X-XXXXXXXXXXX
