------------------------------------------------------------------------------------------------------------------------------------------------------------------------------------------------------------------
------------------------------------------------------------------------------------------------------------------------------------------------------------------------------------------------------------------
-------------------------------------------------------------------------------------------ooo--------------------------------------------------------------------------------------------------------------------
----------------------------------oo-------------------------------------------------------%%%------------------------------------------------------------------oo------------------------------------------------
-------------------------------------------------------------@------------------------------|---------------------------------------------------------------------------------------------------------------------
-------------------------------------------------ooooooo---------------------SSoo----SS-----|----------------------------------------oo---%%%%--------------------%%%%---------------------------------##---------
---------------------------------SSSS---------SSSS------------------------------------------|-------------------------------SSS------SS----||--------------SSS-----||---------------------------------###---------
-----------------------------------------------------------SSSS-----------------------------|----------------------------------------------||------SSS-oo----------||--------------------------------####---------
----------------------------------------------------SSSS------------------------------------|---%%%%------oooo-----------------------------||----------------------||-------------------------------#####---------
-----------------------------------------------------------------------%%%%%%----SS-----SS--|----||--------------%%%%%%-----------------SS-||%%%%%-----SS----------||--------------SS!S------------######---------
---------------------------%%%%------%%%%%------------------------SSS---||||---------------%%%%%%||---------------||||---------------------||-|||------------------||-----------------------------#######---------
-------K-------TT-----------||--------|||-------------------------------||||----------------||||-||---------------||||---------------------||-|||------------------||---------tt--------------tt-########--------F
---------------TT-----------||--------|||--------------%%%%%------------||||----------------||||-||---------------||||---------------------||-|||------------------||---------tt---------gg---tt#########--------#
--M----------kkTT-----------||--------|||---------------|||-------------||||----------------||||-||%%%%%%%%%-%%%%-||||-%%%%%%----%%%%-----%%%%|||------------------||-XXXXXXXXXXXXXXXXXXXXXXXXXXXXXXXXXXXXXXXXXXXX
XXXXXXXXXXXXXXXXXXXXXX--%%%%||%%%%----|||--%%%%--%%%%---|||-------------||||----------------||||-||-|||||||---||--||||--||||------||-------||-|||------------------||-XXXXXXXXXXXXXXXXXXXXXXXXXXXXXXXXXXXXXXXXXXXX
XXXXXXXXXXXXXXXXXXXXXX---||-||-||-----|||---||----||----|||-------------------------------------------------------------------------------------------------------------------------------------------------------
