--------------------------------------------------------------------------------------------------------------------------------XXXXXX----------------
-----------------------------------------------------------------------------------------------------------------------------S------------------------
---------------------------------------------------------------------------------------------SSSSSSSSSSSSSSSSSSSSSSSSSS--SSSSSSS----------------------
---------------------------------------------------------------------------------------------------S----------------------------------SSSSSSS---SSSSSS
---------------------------------------------------------------------------------------------------S-----------------------g----SSS-SS----------------
--------------------------------------------------------------------ySS2---------------------S----------------------------SS-S---S---S----------------
------------------------1---------------------##--------------------S-----------------------------------------------------SS-S------------------------
----------------T----------------------------###--ooo---------------------------------------------------------------------SS-S-------------TT---------
----------------T---------------------------####---------------------K------------------U---------------------------------SC-S----T--------TT---------
----------------T--------------------------#####-----S---------------SS-----T--------t-------S--!!-SC--!!---------@S------SS-S----T--------TT---------
----------S--SSSLSS---------------------#-######-------------------SS------TT-------tt---K-------------------TT-------------------T--S-----TT---------
--------------S-------------------------########--------------------K------TT-------tt-----------------------TT------------------TT--------TT---TT-TT-
----------------------------------------########----------F----------g-----TT-------tt-----k------r--kg---k-kTT------------------TT--------TT---TT-TT-
--------------K-y-----------------g--k--########-------k--#----g---g-XXXXXXXXXXXXXXXXXXXXXXXXXXXXXXXXXXXXXXXXXXXXXXXXXXXXXXXXX---TT---g--gkTT---TT-TT-
XXXXXXXXXXXXXXXXXXXXXXXXXXXXXXXXXXXXXXXXXXXXXXXXXXXXXXXXXXXXXXXXXXXXXXXXXXXXXXXXXXXXXXXXXXXXXXXXXXXXXXXXXXXXXXXXXXXXXXXXXXXXXX---TT---tXXXXXXXXXXXXXXX
XXXXXXXXXXXXXXXXXXXXXXXXXXXXXXXXXXXXXXXXXXXXXXXXXXXXXXXXXXXXXXXXXXXXX------------------------------------------------------------XXXXXXXXXXXXXXXXXXXXX
