------------------------------XXXXXXXXXXXXXXXXXXXXXXXXXXXXXXXXXXXXXXXXXXXXXXXXXXXXXXXXXXXXXXXXXXXXXXXXXXXXXXXXXXXX--XXXXXXXXXXXXXX---XXX--XXXXXXXXXXXXXXXXXXXXXXXXXXXXXXXXXXXXXXXXXXXXXXXXXXXX--XXXXXXXXXXXXXXXXXXXXXXX---XXX--XXXXXXXX--XXXXXXXXXXXXXXXXXXXXXXXXXXXXXXXXXX-
----------------------------------------------------------------------------------------------------------------------------------------------------------------------------------------------------------------------------------------------------------------------------
----------------------------------------------------------------------------------------------------------------------------------------------------------------------------------------------------------------------------------------------------------------------------
----------------------------------------------------------------------------------------------------------------------------------------------------------------------------------------------------------------------------------------------------------------------------
----------------------------------------------------------------------------------------------------------------------------------------------------------------------------------------------------------------------------------------------------------------------------
----------------------------------------------------------------------------------------------------------------------------------------------------------------------------------------------------------------------------------------------------------------------------
-----------------------------------------------------------------------------------------------------------------------------------------------------------------------------------------------------------------------------------------------------------------y----------
--------------------------------------------T1------------1-------------------------------------------------------!!!!------------------------------------------------------------------------!!!!---------------------------------------------------------------##---------
-----------------------------------------------------------------------oooo----------oooo------------oooo-------------------------------------------ooo----------oooo------------oooo--------------------------------------------------------------------------y###---------
---------------------------oo----------------------------------------------------------------------------------------------------------------------------------------------------------------------------------------------------------------------------------####---------
--------------------------------------------------------------------------------------------------------------------y---------------------------------------------------------------------------y-------------------------------------------------------------#####---------
-------K-----------------------------------!!!!---------!!!!----------------------TT--------------TT------------!!@SS!!!--------------------------------------TT--------------TT------------!!@SS!!!---------------------------------------------------------######---C-----
---------------#-----------------------------------------------------#------------TT--------------TT----------------------------------------------#-----------TT--------------TT-------------------------------------------------------#--------------------#######---------
--M----------kk#-----------------------------------------------------#------------TT--------------TT----------------------------------------------#-----------TT--------------TT-----------------------------TT------------------------#-------------------########--------F
XXXXXXXXXXXXXXXXXXXXXXXXX-----X-----k-------yy-----------yy----------#---------y--TT---y------y---TT----------------------------------------------#--------y--TT----------y---TT-----------------------------TT------------------------#----y--y----------#########--------#
XXXXXXXXXXXXXXXXXXXXXXXXX-----XXXXXXXXXXXXXXXXXXXXXXXXXXXXXXXXXXXXXXXXXXXXXXXXXXXXXXXXXXXXXXXXXXXXXXXXXXXXXXXXXXXXX--XXXXXXXXXXXXXX---XXX--XXXXXXXXXXXXXXXXXXXXXXXXXXXXXXXXXXXXXXXXXXXXXXXXXXXX--XXXXXXXXXXXXXXXXXXXXXXX---XXX--XXXXXXXX--XXXXXXXXXXXXXXXXXXXXXXXXXXXXXXXXXX
