---------X--X---X--X--------------------------------------------------------------T-----@--#---t--XXTXXX-X-XX----X---S--------------------------------
---------------------------------------------------------------------------k----------#-T--X-MX#XXFXX-X---XX----X-------------------------------------
------------------X---------------------------S---------------------##----------G--X-------XXXXX--X--X----------------------------------------!-------
--------------#-------------------------------------#-----X-#-------C----#-T---X---X---XXX--X-------------S-!#----------------------------------------
---------r-------------------------------------------------------------tTXXXUXXXX----XXXX-X-----------------------------------------------------------
-----------------------------------------------L----------------S-X---X-XXXXXXXX-X--!X-X-------------------------------------S-------S----------------
-------------------------------#---------------S----------#-----X----XXX-XX-XX---X--X--X----------------------------------------------S------------g-#
------------S----------R--------#---------T------#------------L---|-XX-----X----------------------------------------#-----------------------St--------
------#-S----------------g--------S---------------#--S----TXXXXX#X-XXX------------*------------------------------------------------#------#-XXtXYX---X
----S-----------T-------------------#-XXXX#X-T--X-X-X-----XXXXXXX----R---------------------------------------------------------T-----X---XXXXXX-XXXXXX
------X-----t--------------------XX#-#gX-XXXXXXXXX-XXX-XXXXXX----------------------X--------------------------g---------#--#-----S--#XXXgXXXXX--XXXXXX
---------#-----S-----X-T------X-X--XXXXXXXX-XXXXXXXXX-X-XXX--X------------------------------S-----------T-o--------------t-SX!#T!-XXXTXXXXXX#---------
---------XX--#-#-----S#-TR-XXX-X-X#-XXXX-XX-----#--X-X-------------------k-----S------------------T---t-----!-SS---#--X---XX-XXXXXXX-XXX!-------------
-----X-XXXXX---g-#---t-XXXXXXX----------------------------------------@----------#-------------------X-------------XXX-XX---XXXXX#--T-----------------
XXXXY-X-!--XX-XX-X--X-XX-X-----------------------------------------------------------------------------#UX---XXX-XX-XXX----XX-X---X-----X-------------
XXXXXXX----X-XX-XXXCXt--X------------------------------------------S--------------------------X------#XX-XXXXXXXXXX----------X------------------------
