-----X-X--------t------------X------X---X--------------M--------------T---X-----------------XX---tX----Xg--t---------T-X------#-#X------X---X--r-#----
-----------------------T---------------------------------X------X-X-------------S---------S----X-----X-X--------------X-----------X------g-X-X------#-
-------------#T-----S------L--X---g-XX-#--X----------S---------------------#-X---D!-XX--------X---X-----------------X#---------------X----X---g------!
----------#---------X--X---S-------S---X------------------y-X----X----X--------X-----#---------#---tS-----X---------------------X-X--X----------------
------X-y---X---X-----------X---------t---X--2---X-X--X---------S--T----X--------Xg----#--X------------------X--------X-------------X----X-----S-X----
---------------X--X--X--------X*------X-X---#------X-XX--------X----------t-X-XX-t-----------*X-----------------X---X-------XX---------------S--------
-------XX--------!-----X-X-----X----------X-XXX----------#----X---X--GX---X---------S--XX-X------------X--------X---------XX----#-#-X-----------X-----
----X--X-----X----X------U--#-X-X-X-X--X-#--------------#------X-----------------tX-----X--------X---------X-----X-------r-X--------------DX---------X
-----------#--X----------X----------XX-o-------X-------------X-------#--o--------------X-----------X------!------------X-------X-------------XX-XS----
-------X-----X----------XX----X--------g-X#X--X--X--!----------!-#X---X-X-X-X----------X------------X------X-------Xg----XX---X----X-X-------X--X-XX--
-----------#-------------------X--Xr-----------Ut-YX--#--XX--------------------XX----X------XX------------XX-X-----------------------T------X--XXX--X-
-------------------------------------#-----X---------------X-----#--gX-----X----------X---------------X-------X------XX--X---X-------#-Y--------------
----X------------X------X----X-----X-----------------X--Xy--------X-------X-X--k----------------------TX----X-----------------T------X--S--kX---------
-----X--------------------X--X--#g-X-------XX------------X-X------#X----------T-XXX-----X--X----X--------------#---XX-#---X----T----g--SFX-#---X---X--
XXXXXX--------------------------X------X--#----X---S-------XT#-----X---X!-----X-----X---X-----X#-------------X----X----------T---X------------------M-
XXXXyX--X--S-X---T-XX--X-----X--t------X-----#-------|X--------X---X-------g---#-----X-----XX------S--2--------------X---g------S-------XX---X--------
