-------------------------------------------------------------------------------------------------------------------------------------------------------------
-------------------------------------------------------------------------------------------------------------------------------------------------------------
-------------------------------------------------------------------------------------------------------------------------------------------------------------
-------------------------------------------------------------------------------------------------------------------------------------------------------------
-------------------------------------------------------------------------------------------------------------------------------------------------------------
---------------------------------------------k-------------------------------------------------------------k---------------------------------------k---------
--------------------------------------------S!S--------------------SS!SSS@SSS--------SSC------------------S!S--S!S--------------------------------##---------
-------------------------------------------------------------------------------------------------------------------------------------------------###---------
------------------------------------------------------------------------------------------------g#---------------------------------#-----------k####---------
-----------------------------------tt--------------------------------K---------------SSS-------g##---------------------------k-----#-----------#####---------
-----------------------------------tt-------S!S------------TT------SSSSSSSSSSS-----------------###--------S!S--S@S--------SCSSS----#----------######---------
-------K--------------------TT-----tt----------------------TT---------------------------------####--------------------------K-----##---------#######---------
----------------------------TT-----tt----------------------TT--------------------------------#####--------------------------------##--------########--------F
--M-----------ggg---------kkTT-----tt-----k------gg----k---TT--------------K----------------######------k------ggg--------K---K---##-------#########--------#
XXXXXXXXXXXXXXXXXXXXXXXXXXXXXXXXX--XXXXXXXXXXXXXXXXXXXXXXXXXXXXXXXXXXXXXXXXXXXXXXXXX----XXXXXXXXXX--XXXXXXXXXXXXXXXXXXXXXXXXXXXXXXXX---XXXXXXXXXXXXXXXXXXXXXX
XXXXXXXXXXXXXXXXXXXXXXXXXXXXXXXXX--XXXXXXXXXXXXXXXXXXXXXXXXXXXXXXXXXXXXXXXXXXXXXXXXX----XXXXXXXXXX--XXXXXXXXXXXXXXXXXXXXXXXXXXXXXXXX---XXXXXXXXXXXXXXXXXXXXXX
