------------------------------------------------------------------------------------------------------------------------------------------------------------------------------------------------------------------------------
------------------------------------------------------------------------------------------------------------------------------------------------------------------------------------------------------------------------------
------------------------------------------------------------------------------------------------------------------------------------------------------------------------------------------------------------------------------
------------------------------------------------------------------------------------------------------------------------------------------------------------------------------------------------------------------------------
------------------------------------------------------------------------------------------------------------------------------------------------------------------------------------------------------------------------------
------------------------------------------------------------------------------------------------------------------------------------------------------------------------------------------------------------------------------
--------------------------------------------------------------------------SUS-------------------------------------------------------------------------------------------------------------------------------------###---------
----------------------------------------------------------------------------------------------------------------------------------------------------------------------------------------y-------------------------###---------
--------------------------------------------------------------------------------------------------------------------------------------------TT----------------------------------------#SS--o-------------------y--###---------
--------------------------------------------------------------------------------------------------------------------------------------------TT---------------------------------------##------------------------#--###---------
-------------------------------------------------------------------------#####-----------------------------------------------------#LSS-----##----------------------!!--------------###--SC-------------------##--###---------
-------K--------------------TT-----TT----K-------------------------------#--------------------------#------------------------------#-----------------------------------------------####---------------------y###--###---------
----------------------------TT-----TT-----------------------------------K#---------------------*----#------------------------------#-----------*---TT-----*--------------------y-######---SSS---------------####--###--------F
--M-----------ggg---------kkTT-----TT-----------ggg-------ggg------------#--------------ggg----*----#----ggg--k----ggg-----------kk#-----------*---TT-----*-----k-------------#########--------------------#####--###--------#
XXXXXXXXXXXXXXXXXXXXXXXXXXXXXXXXX--XXXXXXXXXXXXXXXXXXXXXXXXXXXXXXXXXXXXXXXXX----XXXXXXXXXXXXXXXXXX--XXXXXXXXXXXXXXXXXXXXXXXXXXXXXXXXXXXX---XXXXXXXXXXXXXXXXXXXXXXXXXXXXX--XXXXXXXXXXXXX------XXXXXXXXX---XXXXXXX--XXXXXXXXXXXX
XXXXXXXXXXXXXXXXXXXXXXXXXXXXXXXXX--XXXXXXXXXXXXXXXXXXXXXXXXXXXXXXXXXXXXXXXXX----XXXXXXXXXXXXXXXXXX--XXXXXXXXXXXXXXXXXXXXXXXXXXXXXXXXXXXX---XXXXXXXXXXXXXXXXXXXXXXXXXXXXX--XXXXXXXXXXXXX------XXXXXXXXX---XXXXXXX--XXXXXXXXXXXX
