--------------------------------------------------------------------------------------------------------------------------------------------------------------------------------------------------------------------------------------------------------------------------------------
--------------------------------------------------------------------------------------------------------------------------------------------------------------------------------------------------------------------------------------------------------------------------------------
--------------------------------------------------------------------------------------------------------------------------------------------------------------------------------------------------------------------------------------------------------------------------------------
--------------------------------------------------------------------------------------------------------------------------------------------------------------------------------------------------------------------------------------------------------------------------------------
---------------------------------------------------------------------------------------------------------------------------------------------------------------------------------------------------------------------------------------------------------------------------K----------
-----------------------------------------------------------oo-------------------------------------------------------------------------------------------------------------------------------------------------------------------------------------------------------------------------
--------------------------------------------------------------------------------------------------------SSSSCSSS-----------------------------------------------------------------------------------------------------------------------------------------------------------##---------
--------------------------------------------------------------------------------------------------------------------------------------------------------------------------------------------------------------------------------------------------------------------------###---------
-----------------------------------------------------------------------------------------------------------------------------------------------------------------------------------------------------------------------------------T-------------------------------------####---------
-----------------------------oo-----------------o-------------------------------------------------------------------------------------SSUSSSSS-------------------------------oo---------------------tt-----------------------------TT-----------------------------------#####---------
--------------------------------------------TT--------TT-----------------------------------------------#----2----#------------------------------------------------------------------------------TT--tt-----------------------------TT------TT-------TT----------------TT#####---------
-------K------------------------------------TT--------TT----------------------------------TT-----------#------K--#-------K------------------------------------------------------------------TT--TT--tt-----------------------------TT------TT-----TTTT----TT---------#TT#####---------
---------------#-----------------------y----TT--------TT---------tt-----------------------TT-----------#---------#-----------K----------------------------------#---------------------------TT--TT--tt-----------------------------TT------TT---TTTTTT----TT--------##TT#####--------F
--M----------kk#-----------------------##---TT--------TT---ggg---tt-k----kkk---kkk--------TT------ggg--#---------#--------------------------------------------kk#----------------------ggg--TT--TT--tt-----k--ggg-----ggg------ggg-TT------TT---TTTTTT----TT-------###TT#####--------#
XXXXXXXXXXXXXXXXXXXXXXXXXXX------XXXXXXXXXXXXXXXXXXXXXXXXXXXXXXXXXXXXXXXXXXXXXXXXXXXXXXXXXXXXXXXXXXXXXXXXXXXXXXXXXXXXXX-X-XX-X-XX-XXXXXXXXXXXXXXXXX-X-X-XXXXXXXXXXXXXXXXXXX------XXXXXXXXXX-XX--XX--XXXXXXXXXXXXXXXXXXXXXXXXXXXXXXXXXXXXXXXXXXXXXXXXXXXXXXXXXXXXXXXXXXXXXXXXXXXXXXXXXX
XXXXXXXXXXXXXXXXXXXXXXXXXXX------XXXXXXXXXXXXXXXXXXXXXXXXXXXXXXXXXXXXXXXXXXXXXXXXXXXXXXXXXXXXXXXXXXXXXXXXXXXXXXXXXXXXXX-X-XX-X-XX-XXXXXXXXXXXXXXXXX-X-X-XXXXXXXXXXXXXXXXXXX------XXXXXXXXXX-XX--XX--XXXXXXXXXXXXXXXXXXXXXXXXXXXXXXXXXXXXXXXXXXXXXXXXXXXXXXXXXXXXXXXXXXXXXXXXXXXXXXXXXX
