----------------------------------------------------------------------------------------------------------------------------------------------------------------------------------------------------------------------------------------
----------------------------------------------------------------------------------------------------------------------------------------------------------------------------------------------------------------------------------------
----------------------------------------------------------------------------------------------------------------------------------------------------------------------------------------------------------------------------------------
-----------------------------------------------------------------------------------------------------------------------------------------------------------------------------------------------------------------------------y----------
----------------------------------------------------------------------------------------------------------------------------------------------------------!!!!---------------------------------------------------------------##---------
-----------------------------------------------------------------------------------------------------------------------------oooo------------oooo--------------------------------------------------------------------------y###---------
--------------------------------------!!!!!-----------USSS--------SSCSS------SSSS-----------------------------TT-----------------------------------------------------------------------------------------------------------####---------
--------------------------------------------------------------------------------------------------------------TT--------------------------------------------y-------------------------------------------------------------#####---------
-----------------------------------------------------------------------------------------------------#LSS-----##----------TT--------------TT------------!!@SS!!!---------------------------------------------------------######---C-----
----------------------------------------k-----------------------------------------------g------------#--------------------TT--------------TT-------------------------------------------------------#--------------------#######---------
-------------------------------TT-----@!!!!----------S-----TT---!!!!--!!!---------------T------------#-----------*---TT---TT--------------TT-----------------------------TT------------------------#-------------------########--------F
-------K-----------------------TT--------------------------TT---------------------------T----------kk#-----------*---TT---TT---y------y---TT-----------------------------TT------------------------#----y--y----------#########--------#
-------------------------------TT--------------------------TT---------------------------TXXXXXXXXXXXXXXXXX---XXXXXXXXXXXX-XXXXXXXXXXXXXXXXXXXXXXXXXXXXXXXXX--XXXXXXXXXXXXXXXXXXXXXXX---XXX--XXXXXXXX--XXXXXXXXXXXXXXXXXXXXXXXXXXXXXXXXXX
--M-----------ggg-------ggg----TT------------gg----k-ggg---TT------------ggg------------TXXXXXXXXXXXXXXXXX---XXXXXXXXXXXX-XXXXXXXXXXXXXXXXXXXXXXXXXXXXXXXXX--XXXXXXXXXXXXXXXXXXXXXXX---XXX--XXXXXXXX--XXXXXXXXXXXXXXXXXXXXXXXXXXXXXXXXXX
XXXXXXXXXXXXXXXXXXXXXXXXXXXXXXXXXXXXXXXXXXXXXXXXXXXXXXXXXXXXXXXXXXXXXXXXXXXXX----XXXXXXXXX----------------------------------------------------------------------------------------------------------------------------------------------
XXXXXXXXXXXXXXXXXXXXXXXXXXXXXXXXXXXXXXXXXXXXXXXXXXXXXXXXXXXXXXXXXXXXXXXXXXXXX----XXXXXXXX-----------------------------------------------------------------------------------------------------------------------------------------------
