-------------------------------------------------------------------------------------------------------------------------------------------------------------------------------------------------------------
-------------------------------------------------------------------------------------------------------------------------------------------------------------------------------------------------------------
-------------------------------------------------------------------------------------------------------------------------------------------------------------------------------------------------------------
-------------------------------------------------------------------------------------------------------------------------------------------------------------------------------------------------------------
-------------------------------------------------------------------------------------------------------------------------------------------------------------------------------------------------------------
-------------------------------------------------------------------------------------------------------------------------------------------------------------------------------------------------------------
-------------------------------------------------------------------------------------------------------------------------------------------------------------------------------------------------###---------
-----------------------------------------------------------------------------------------------------------------------------------------------------------------------y-------------------------###---------
------------------------------#----------------------------------------------------------------------------------------------------------------y---------------------#SS--o-------------------y--###---------
-----------------------------##--oo------o----o-------------------oo---oo---ooo---------------------oo---oo------------------------------------XSS-@!---------------##------------------------#--###---------
----------------------------###---------------------------------------------------------------------------------------------------------------XX-------------------###--SC-------------------##--###---------
-------K-------------------####-------------------------------------------------------------------------------------------------TT-----------XXX------------------####---------------------y###--###---------
--------------------------#####----------------------#---#-----------------------------#---#------------------------------------TT----------XXXX-------y---------#####---SSS---------------####--###--------F
--M-----------ggg------gg######--k-------------------#-k-#-----------------------------#-k-#-----------------------k------kkk---TT---------XXXXX---SSSSS-----y--######--------------------#####--###--------#
XXXXXXXXXXXXXXXXXXXXXXXXXXXXXXXXXXXXXXXX---XX---XXXXXXXXXXXXXXXX-----X----X-----XXXXXXXXXXXXXXXXXX-----X----XXXXXXXXXXXXXXXXXXXXXXXXXXXXXXXXXXXX-------XX-XXXXXXXXXXXX------XXXXXXXXX---XXXXXXX--XXXXXXXXXXXX
XXXXXXXXXXXXXXXXXXXXXXXXXXXXXXXXXXXXXXXX---XX---XXXXXXXXXXXXXXXX-----X----X-----XXXXXXXXXXXXXXXXXX-----X----XXXXXXXXXXXXXXXXXXXXXXXXXXXXXXXXXXXX-------XX-XXXXXXXXXXXX------XXXXXXXXX---XXXXXXX--XXXXXXXXXXXX
