--------------------------------------------------------------------------------------------------------------------------------------------------------------------------------------------------------------------------------------------------------------------------------------
--------------------------------------------------------------------------------------------------------------------------------------------------------------------------------------------------------------------------------------------------------------------------------------
--------------------------------------------------------------------------------------------------------------------------------------------------------------------------------------------------------------------------------------------------------------------------------------
--------------------------------------------------------------------------------------------------------------------------------------------------------------------------------------------------------------------------------------------------------------------------------------
--------------------------------------------------------------------------------------------------------------------------------------------------------------------------------------------------------------------------------------------------------------------------------------
-------------------------------------------k-------------------------------------------------------------------------------------------------------------------------------------------------------------------------------------------------------------------------------y----------
--------------C------SSC------------------S!S--S!S-----------------------------SS!SSS@SSS--------SSC-------------------------------------------------------------------------!--------------------------!!!!---------------------------------------------------------------##---------
-------------------------------------------------------------------------------------------------------------------------------------------------------------------------------------------------------------------------------------------------------------------------y###---------
--------------------------------g#---------------------------------#-----------------------------------------------------------------------------------------------------------------------------------------------------------------------------------------------------####---------
---------------------SSS-------g##---------------------------k-----#-------------K---------------SSS-------g-T----------------------------o---------------1--------o------------------------oo------------y-------------------------------------------------------------#####---------
-------------SS----------------###--------S!S--S@S--------SCSSS----#-----------SSSSSSSSSSS-----------------#-TT---------------------------------------TT---------------------!-!-----------o--o-------!!@SS!!!---------------------------------------------------------######---C-----
-------K----------------------####--------------------------K-----##--------------------------------------##-TT---------------------------------------TT----TT--------K--------------------------------------------------------------------------#--------------------#######---------
-----------------------------#####--------------------------------##-------------------------------------###-TT---------------------------------------TT----TT---------------------------------------------------------TT------------------------#-------------------########--------F
--M-----------k-------------######------k------ggg--------K---K---##-------y-----------K----------------####-TT----k-k---------------k---------ggg----TT---kTT---------------------------------------------------------TT------------------------#----y--y----------#########--------#
XXXXXXXXXXXXXXXXXXXX----XXXXXXXXXX--XXXXXXXXXXXXXXXXXXXXXXXXXXXXXXXX---XXXXXXXXXXXXXXXXXXXXXXXXX----XXXXXXXXXXXXXXXXXXXX-X-XX-XX-XX-XXXXXXXXXXXXXXXXXXXXXXXXXXXXXXXXXXXXXXXXXXXXXX--XXXXXXXXXXXXXXXXXXXXX--XXXXXXXXXXXXXXXXXXXXXXX---XXX--XXXXXXXX--XXXXXXXXXXXXXXXXXXXXXXXXXXXXXXXXXX
XXXXXXXXXXXXXXXXXXXX----XXXXXXXXXX--XXXXXXXXXXXXXXXXXXXXXXXXXXXXXXXX---XXXXXXXXXXXXXXXXXXXXXXXXX----XXXXXXXXXXXXXXXXXXXX-X-XX-XX-XX-XXXXXXXXXXXXXXXXXXXXXXXXXXXXXXXXXXXXXXXXXXXXXX--XXXXXXXXXXXXXXXXXXXXX--XXXXXXXXXXXXXXXXXXXXXXX---XXX--XXXXXXXX--XXXXXXXXXXXXXXXXXXXXXXXXXXXXXXXXXX
