----------------------------------------------------------------------------------------------------------------------------------------------------------------------------
----------------------------------------------------------------------------------------------------------------------------------------------------------------------------
----------------------------------------------------------------------------------------------------------------------------------------------------------------------------
----------------------------------------------------------------------------------------------------------------------------------------------------------------------------
----------------------------------------------------------------------------------------------------------------------------------------------------------------------------
----------------------------------------------------------------------------------------------------------------------------------------------------------------------------
--------------------------------------------------------------SUS------------------------------------------------------------------------------------------------##---------
-----------------------------------------------------------------------------------------------------------------------------------------------------------------##---------
--------------------------------------------------------------------------------------------------------------------------------TT-------------------------------##---------
--------------------------------------------------------------------------------------------------------------------------------TT------------------------K---#--##---------
-------------------------------------------------------------#####-----------------------------------------------------#LSS-----##---------------------------##--##---------
-------K-----------------------------------------------------#--------------------------#------------------------------#------------------------------------###--##---------
----------------------------#-------------------------------K#---------------------*----#------------------------------#-----------*---TT-----*------------####------------F
--M-----------ggg---------kk#-------ggg-------ggg------------#--------------ggg----*----#----ggg--k----ggg-----------kk#-----------*---TT-----*-----K-----#####------------#
XXXXXXXXXXXXXXXXXXXXXXXXXXXXXXXXXXXXXXXXXXXXXXXXXXXXXXXXXXXXXXXX----XXXXXXXXXXXXXXXXXX--XXXXXXXXXXXXXXXXXXXXXXXXXXXXXXXXXXXX---XXXXXXXXXXXXXXXXXXXXXXXXXXXXXXXXXXXXXXXXXXXXX
XXXXXXXXXXXXXXXXXXXXXXXXXXXXXXXXXXXXXXXXXXXXXXXXXXXXXXXXXXXXXXXX----XXXXXXXXXXXXXXXXXX--XXXXXXXXXXXXXXXXXXXXXXXXXXXXXXXXXXXX---XXXXXXXXXXXXXXXXXXXXXXXXXXXXXXXXXXXXXXXXXXXXX
