----------------------------------------------------------------------------------------------------------------------------------------------------------------------------------------------------------------------
----------------------------------------------------------------------------------------------------------------------------------------------------------------------------------------------------------------------
----------------------------------------------------------------------------------------------------------------------------------------------------------------------------------------------------------------------
----------------------------------------------------------------------------------------------------------------------------------------------------------------------------------------------------------------------
----------------------------------------------------------------------------------------------------------------------------------------------------------------------------------------------------------------------
----------------------------------------------------------------------------------------------------------------------------------------------------------------------------------------------------------------------
---------------------------------------------------------------------------------------SUS--------------SUS------------------------------------------------------------------------------------------------##---------
-----------------------------------------------------------------------------------------------------------------------------------------------------------------------------------------------------------##---------
--------------------------------------------------------------------------------------------------------------------------------------------------------------------------TT-------------------------------##---------
-----------------------------oo-------------------------------------------------------------------------------------------------------------------------------------------TT------------------------K---#--##---------
--------------------------------------------------------------------------------------#####------------#####-----------------------------------------------------#LSS-----##---------------------------##--##---------
-------K------------------------------------TT--TT----K-------------------------------#----------------#--------------------------#------------------------------#------------------------------------###--##---------
---------------#----------------------------TT--TT-----------------------------------K#---------------K#---------------------*----#------------------------------#-----------*---TT-----*------------####------------F
--M----------kk#-----------------------ggg--TT--TT-----------ggg-------ggg------------#----------------#--------------ggg----*----#----ggg--k----ggg-----------kk#-----------*---TT-----*-----K-----#####------------#
XXXXXXXXXXXXXXXXXXXXXXXXXXX------XXXXXXXXXX-XX--XXXXXXXXXXXXXXXXXXXXXXXXXXXXXXXXXXXXXXXXX----XXXXXXXXXXXXX----XXXXXXXXXXXXXXXXXX--XXXXXXXXXXXXXXXXXXXXXXXXXXXXXXXXXXXX---XXXXXXXXXXXXXXXXXXXXXXXXXXXXXXXXXXXXXXXXXXXXX
XXXXXXXXXXXXXXXXXXXXXXXXXXX------XXXXXXXXXX-XX--XXXXXXXXXXXXXXXXXXXXXXXXXXXXXXXXXXXXXXXXX----XXXXXXXXXXXXX----XXXXXXXXXXXXXXXXXX--XXXXXXXXXXXXXXXXXXXXXXXXXXXXXXXXXXXX---XXXXXXXXXXXXXXXXXXXXXXXXXXXXXXXXXXXXXXXXXXXXX
