-----------------------------------------------------------------------------------------------------------------------------------------------------------------------------------------------------------------------------------------------------------------------------------
-----------------------------------------------------------------------------------------------------------------------------------------------------------------------------------------------------------------------------------------------------------------------------------
-----------------------------------------------------------------------------------------------------------------------------------------------------------------------------------------------------------------------------------------------------------------------------------
-----------------------------------------------------------------------------------------------------------------------------------------------------------------------------------------------------------------------------------------------------------------------------------
-----------------------------------------------------------------------------------------------------------------------------------------------------------------------------------------------------------------------------------------------------------------------------------
---------------------------------------------------------------------------------------------------------------------------------------------------------------------------------------------------------------------------------k---------------------------------------k---------
----------------------------------------SUS-----------------------------------------------------------------------------------------------------------------1-------USS------------------SS!SSS@SSS--------SSC------------------S!S--S!S--------------------------------##---------
-----------------------------------------------------------------------------------------------------------------------------------------------------------------------------------------------------------------------------------------------------------------------###---------
----------------------------------------------------------------------------------------------------------TT----------------------------------TT----------------------------------------------------------------------g#---------------------------------#-----------k####---------
----------------------------------------------------------------------------------------------------------TT------------------------K---#-----TT------------ggg----------------------------K---------------SSS-------g##---------------------------k-----#-----------#####---------
---------------------------------------#####-----------------------------------------------------#LSS-----##---------------------------##-----##------##########---#-------------TT------SSSSSSSSSSS-----------------###--------S!S--S@S--------SCSSS----#----------######---------
-------K-------------------------------#--------------------------#------------------------------#------------------------------------###------------##--------#---#-------------TT---------------------------------####--------------------------K-----##---------#######---------
--------------------------------------K#---------------------*----#------------------------------#-----------*---TT-----*------------####-----------###--------#---##------------TT--------------------------------#####--------------------------------##--------########--------F
--M-----------ggg-------ggg------------#--------------ggg----*----#----ggg--k----ggg-----------kk#-----------*---TT-----*-----K-----#####--------k-####--------#---##--gg----k---TT--------------K----------------######------k------ggg--------K---K---##-------#########--------#
XXXXXXXXXXXXXXXXXXXXXXXXXXXXXXXXXXXXXXXXXX----XXXXXXXXXXXXXXXXXX--XXXXXXXXXXXXXXXXXXXXXXXXXXXXXXXXXXXX---XXXXXXXXXXXXXXXXXXXXXXXXXXXXXXXX---XXXXXXXXXXX--------X---XXXXXXXXXXXXXXXXXXXXXXXXXXXXXXXXXXXXXXX----XXXXXXXXXX--XXXXXXXXXXXXXXXXXXXXXXXXXXXXXXXX---XXXXXXXXXXXXXXXXXXXXXX
XXXXXXXXXXXXXXXXXXXXXXXXXXXXXXXXXXXXXXXXXX----XXXXXXXXXXXXXXXXXX--XXXXXXXXXXXXXXXXXXXXXXXXXXXXXXXXXXXX---XXXXXXXXXXXXXXXXXXXXXXXXXXXXXXXX---XXXXXXXXXXX--------X---XXXXXXXXXXXXXXXXXXXXXXXXXXXXXXXXXXXXXXX----XXXXXXXXXX--XXXXXXXXXXXXXXXXXXXXXXXXXXXXXXXX---XXXXXXXXXXXXXXXXXXXXXX
