------------------------------------------------------------------------------------------------------------------------------------------------------
------------------------------------------------------------------------------------------------------------------------------------------------------
------------------------------------------------------------------------------------------------------------------------------------------------------
------------------------------------------------------------------------------------------------------------------------------------------------------
------------------------------------------------------------------------------------------------------------------------------------------------------
------------------------------------------------------------------------------------------------------------------------------------------------------
--------------------------------------------------------------------------SUS--------------------------------------------------------------##---------
-------------------------------------------------------------------------------------------------------------------------------------------##---------
-----------------------------------------------------------------------------------------------------------------------------------------#-##---------
-----------------------------------------------------------------------------------------------------------------------------------------#-##---------
-------------------------------------------------------------------------#####---------------------------------------------------------#-#-##---------
-------K--------------------TT-----TT----K-------------------------------#-------------------------------------------TT----------------#-#-##---------
----------------------------TT-----TT-----------------------------------K#---------------------*----%----------------TT---------TT---#-#-#-##--------F
--M-----------ggg---------kkTT-----TT-----------ggg-------ggg------------#--------------ggg----*----t----------kkk---TT---------TT---#-#-#-##--------#
XXXXXXXXXXXXXXXXXXXXXXXXXXXXXXXXX--XXXXXXXXXXXXXXXXXXXXXXXXXXXXXXXXXXXXXXXXX----XXXXXXXXXXXXXXXXXX--XXXXXXXXXXXXXXXXXXXXXXXXXXXXXXXX-X-X-X-XXXXXXXXXXX
XXXXXXXXXXXXXXXXXXXXXXXXXXXXXXXXX--XXXXXXXXXXXXXXXXXXXXXXXXXXXXXXXXXXXXXXXXX----XXXXXXXXXXXXXXXXXX--XXXXXXXXXXXXXXXXXXXXXXXXXXXXXXXX-X-X-X-XXXXXXXXXXX
