---------------------------------------------------------------------------------------------------------------------------------------------------------------------------------------------------------------------------------------------------------------------------------------------------------------------------------------------------------------------
---------------------------------------------------------------------------------------------------------------------------------------------------------------------------------------------------------------------------------------------------------------------------------------------------------------------------------------------------------------------
---------------------------------------------------------------------------------------------------------------------------------------------------------------------------------------------------------------------------------------------------------------------------------------------------------------------------------------------------------------------
---------------------------------------------------------------------------------------------------------------------------------------------------------------------------------------------------------------------------------------------------------------------------------------------------------------------------------------------------------------------
---------------------------------------------------------------------------------------------------------------------------------------------------------------------------------------------------------------------------------------------------------------------------------------------------------------------------------------------------------------------
----------------------------------------------------------------------------------------------------------------------------------------------------------------------------------------------------------------------------------------------------------------------------------------------------------------------------------------------------------y----------
------------------------------------------SUS-----SS-------------SSS---------------------------------------------------------------S-----------LSSS----------------------------------------------------------------------------1-------------------------------------------------------!!!!---------------------------------------------------------------##---------
------------------------------------------------------------------------TT------------------------------------------------------------------------------------------------------------------------------------------------------------------oooo----------oooo------------oooo--------------------------------------------------------------------------y###---------
------------------------------------------------------------------------TT-----------------------------------------------------------------g------------------------------------------------------------------------------------------------------------------------------------------------------------------------------------------------------------####---------
------------------------------------------------------------------------TT-----------------------------------------------------------------#-------------------------------------------------o-------------------------------------------------------------------------------------------y-------------------------------------------------------------#####---------
-----------------------------------------######-SSSS---------#---SSS----XX------------------S-S-----#--#----------##--#------------SS-----##---2-----#----------TT-----------------------------------------------------------!!!!----------------------TT--------------TT------------!!@SS!!!---------------------------------------------------------######---C-----
-------K---------------------------------#--------------#-TT-#-------------------------------------##--##--------###--##-----------------###---------#----------TT------------------------------------------------------------------------#------------TT--------------TT-------------------------------------------------------#--------------------#######---------
----------------------------------------K#-------------##-TT-##---------------#-------------------###--###------####--###-----t%%#------####---------##---------TT------------------------------------------------------------------------#------------TT--------------TT-----------------------------TT------------------------#-------------------########--------F
--M-----------ggg-------ggg--------------#------------###-TT-##---------k-------k-g-g--------k---####--####----#####--####----t||#-----#####----kk---##-----ggg-TT----k-k---------------k---------ggg--------y-y--------------yy----------#---------y--TT---y------y---TT-----------------------------TT------------------------#----y--y----------#########--------#
XXXXXXXXXXXXXXXXXXXXXXXXXXXXXXXXXXXXXXXXXXXX----XXXXXXXXX-XXXXXXXXXXXXXXXXXXXXXXXXXXXXXXXXXXXXXXXXXXXXXXXXXXXXXXXXXX--XXXXXXXXXXXXXXXXXXXXXXXXXXXXXXXXXXXXXXXXXXXXXXXXXXXXX-X-XX-XX-XX-XXXXXXXXXXXXXXXXXXXXXXXXXXXX---XXXXXXXXXXXXXXXXXXXXXXXXXXXXXXXXXXXXXXXXXXXXXXXXXXXXXXXXXXXXXXXXXX--XXXXXXXXXXXXXXXXXXXXXXX---XXX--XXXXXXXX--XXXXXXXXXXXXXXXXXXXXXXXXXXXXXXXXXX
XXXXXXXXXXXXXXXXXXXXXXXXXXXXXXXXXXXXXXXXXXXX----XXXXXXXXX-XXXXXXXXXXXXXXXXXXXXXXXXXXXXXXXXXXXXXXXXXXXXXXXXXXXXXXXXXX--XXXXXXXXXXXXXXXXXXXXXXXXXXXXXXXXXXXXXXXXXXXXXXXXXXXXX-X-XX-XX-XX-XXXXXXXXXXXXXXXXXXXXXXXXXXXX---XXXXXXXXXXXXXXXXXXXXXXXXXXXXXXXXXXXXXXXXXXXXXXXXXXXXXXXXXXXXXXXXXX--XXXXXXXXXXXXXXXXXXXXXXX---XXX--XXXXXXXX--XXXXXXXXXXXXXXXXXXXXXXXXXXXXXXXXXX
