-----------------------------------------------------------------------------------
-----------------------------------------------------------------------------------
-----------------------------------------------------------------------------------
-----------------------------------------------------------------------------------
-----------------------------------------------------------------------------------
-----------------------------------------------------------------------------------
-----------------------------------------------------------------------###---------
---------------------------------------------y-------------------------###---------
-------------------------------------------#SS--o-------------------y--###---------
-----------------------------o------------##------------------------#--###---------
-----------------------------------------###--SC-------------------##--###---------
-------K--------------------------------####---------------------y###--###---------
---------------#--------------------y#######---SSS---------------####--###--------F
--M----------kk#--------------------########--------------------#####--###--------#
XXXXXXXXXXXXXXXXXXXXXXXXXXX----XXXXXXXXXXXXX------XXXXXXXXX---XXXXXXX--XXXXXXXXXXXX
XXXXXXXXXXXXXXXXXXXXXXXXXXX----XXXXXXXXXXXXX------XXXXXXXXX---XXXXXXX--XXXXXXXXXXXX
