-------------------------------------------------------------------------------------------------------------------------------------------------------------------------------------------------------------------------------------------------------------------------------------------------------------------------------------------------------------------------------------------------%-||----||----X
---------------------------------------------------------------------------------------------------------------------------------------------------------------------------------------------------------------------------------------------------------------------------------------------------------------------------------------------------------------------------------------------------||----||----X
----------------------------------------------------------------------------------------------------------------------------------------------------------------------------------------------------------------------------------------------------------------------------------------------------------------------------------------------------------------------------------------------------------------
------------------------------------------------------------------------------------------------------------------------------------------------------------------------------------------------------------------------------------------------------------------------------------------------------------------------------------------------------------------------------------------oo--------------------
----------------------------------------------------------------------------------------------------------------------------------------------------------------------------------------------------------------------------------------------------------------------------------------------------------------------------------------------------------------------------------------------------------------
----------------------------------------------------------------------------------------------------------------------------------------------------------------------------------------------------------------------------------------------------------------------------------------------------------------------------------------------------------------------------------------------------------------
--------------------------------------------------------------------------SUS-----------------------------------------------------------------------------------------------------------------------------------------------1---------------------------------------!!!!-----------------------------------------------------------------------------------------------------------------SSSS-------------------
---------------------------------------------------------------------------------------------------------------------------------------------------------------------------oooo----------------------------------------------------------oooo----------oooo-----------------------------------------------------------------------------------------------------------------------------------------------------
--------------------------------------------------------------------------------------------------------------------------------------------TT---------------------------------------------------------------------------------------------------------------------------------------------------------------------------------------------------------------------------------------------------------oo-------
--------------------------------------------------------------------------------------------------------------------------------------------TT------------------------K-----------------------------oo----------------------------------------------------------------y-----------------------------------------------o---------------1--------o--------o-------------------------------------------------------
-------------------------------------------------------------------------#####-----------------------------------------------------#LSS-----##---------------------------#------------TT-----------o--o-------------------!!!!----------------------TT------------!!@SS!!!--------------------------------------------------------TT----------------TT--------TT-------TT----------%%%%------%------------------
-------K--------------------TT-----TT----K-------------------------------#--------------------------#------------------------------#------------------------------------##------------TT----K------------------------------------------#------------TT-------------------------------------------------------#--------------------TT----TT----------TT--------TT-------TT-----------||--------%%%---------------
----------------------------TT-----TT-----------------------------------K#---------------------*----#------------------------------#-----------*---TT-----*------------###------------TT-----------------------------------------------#------------TT-----------------------------TT------------------------#--------------------TT----TT----------TT--------TT-------TT-----------||--------||---%%%%--%%%%---
--M-----------ggg---------kkTT-----TT-----------ggg-------ggg------------#--------------ggg----*----#----ggg--k----ggg-----------kk#-----------*---TT-----*-----K-----####---------y--TT-k----------------------y----------yy----------#---------y--TT-----------------------------TT------------------------#---k---------ggg----TT---kTT----------TT--------TT---ggg-TT-----------||--------||----||----||----
XXXXXXXXXXXXXXXXXXXXXXXXXXXXXXXXX--XXXXXXXXXXXXXXXXXXXXXXXXXXXXXXXXXXXXXXXXX----XXXXXXXXXXXXXXXXXX--XXXXXXXXXXXXXXXXXXXXXXXXXXXXXXXXXXXX---XXXXXXXXXXXXXXXXXXXXXXXXXXXXXXXXXXXXXXXXXXXXXXXXXXXXXXXXXXXXXXXXXXXXXXXXXXXXXXXXXXXXXXXXXXXXXXXXXXXXXXXXXXXXXXXXXXXXXXXXXX--XXXXXXXXXXXXXXXXXXXXXXX---XXX--XXXXXXXX--XXXXXXXXXXXXXXXXXXXXXXXXXXXXXXXXXXXXXXXXXXXXXXXXXXXXXXXXXXXXXX--%%%%||%%%%----||----||----||----
XXXXXXXXXXXXXXXXXXXXXXXXXXXXXXXXX--XXXXXXXXXXXXXXXXXXXXXXXXXXXXXXXXXXXXXXXXX----XXXXXXXXXXXXXXXXXX--XXXXXXXXXXXXXXXXXXXXXXXXXXXXXXXXXXXX---XXXXXXXXXXXXXXXXXXXXXXXXXXXXXXXXXXXXXXXXXXXXXXXXXXXXXXXXXXXXXXXXXXXXXXXXXXXXXXXXXXXXXXXXXXXXXXXXXXXXXXXXXXXXXXXXXXXXXXXXXX--XXXXXXXXXXXXXXXXXXXXXXX---XXX--XXXXXXXX--XXXXXXXXXXXXXXXXXXXXXXXXXXXXXXXXXXXXXXXXXXXXXXXXXXXXXXXXXXXXXX---||-||-||-----||-%--||----||----
