-------------------------------------------------------------------------------------------------------------------------------------------------------------------------------------------------------------------------------------------
-------------------------------------------------------------------------------------------------------------------------------------------------------------------------------------------------------------------------------------------
-------------------------------------------------------------------------------------------------------------------------------------------------------------------------------------------------------------------------------------------
-------------------------------------------------------------------------------------------------------------------------------------------------------------------------------------------------------------------------------------------
-------------------------------------------------------------------------------------------------------------------------------------------------------------------------------------------------------------------------------------------
-------------------------------------------------------------------------------------------------------------------------------------------------------------------------------------------------------------------------------------------
--------------------------------------------------------------------------SUS---------------------------------------------------------------------------------------------------------------------------------------------------##---------
-------------------------------------------------------------------------------------------------------------------------------------------------------------------------------------------------------------------------------###---------
--------------------------------------------------------------------------------------------------------------------------------------------TT--------------------------------------------------------------------------------####---------
--------------------------------------------------------------------------------------------------------------------------------------------TT------------------------K---#--------------------------------------------------#####---------
-------------------------------------------------------------------------#####-----------------------------------------------------#LSS-----##---------------------------##--#--#----------##--#------------SS!S------------######---------
-------K--------------------TT-----TT----K-------------------------------#--------------------------#------------------------------#------------------------------------###--#--##--------###--##--------------------------#######---------
----------------------------TT-----TT-----------------------------------K#---------------------*----#------------------------------#-----------*---TT-----*------------####--#--###------####--###-----tt--------------tt-########--------F
--M-----------ggg---------kkTT-----TT-----------ggg-------ggg------------#--------------ggg----*----#----ggg--k----ggg-----------kk#-----------*---TT-----*-----K-----#####--#--####----#####--####----tt---------gg---tt#########--------#
XXXXXXXXXXXXXXXXXXXXXXXXXXXXXXXXX--XXXXXXXXXXXXXXXXXXXXXXXXXXXXXXXXXXXXXXXXX----XXXXXXXXXXXXXXXXXX--XXXXXXXXXXXXXXXXXXXXXXXXXXXXXXXXXXXX---XXXXXXXXXXXXXXXXXXXXXXXXXXXXXXXXXXXXXXXXXXXXXXXXXX--XXXXXXXXXXXXXXXXXXXXXXXXXXXXXXXXXXXXXXXXXXXX
XXXXXXXXXXXXXXXXXXXXXXXXXXXXXXXXX--XXXXXXXXXXXXXXXXXXXXXXXXXXXXXXXXXXXXXXXXX----XXXXXXXXXXXXXXXXXX--XXXXXXXXXXXXXXXXXXXXXXXXXXXXXXXXXXXX---XXXXXXXXXXXXXXXXXXXXXXXXXXXXXXXXXXXXXXXXXXXXXXXXXX--XXXXXXXXXXXXXXXXXXXXXXXXXXXXXXXXXXXXXXXXXXXX
