--------------------------------------------------------------------------------------------------------------------------------------------------------------------------
--------------------------------------------------------------------------------------------------------------------------------------------------------------------------
--------------------------------------------------------------------------------------------------------------------------------------------------------------------------
--------------------------------------------------------------------------------------------------------------------------------------------------------------------------
--------------------------------------------------------------------------------------------------------------------------------------------------------------------------
------------------------------------------------------------------------------------------------------------------------k---------------------------------------k---------
---------------------------------------------------1-------USS------------------SS!SSS@SSS--------SSC------------------S!S--S!S--------------------------------##---------
--------------------------------------------------------------------------------------------------------------------------------------------------------------###---------
-------------------------------------------------------------------------------------------------------------g#---------------------------------#-----------k####---------
------------------------------oo-------------------ggg----------------------------K---------------SSS-------g##---------------------------k-----#-----------#####---------
----------------------------------------------#########---#-------------TT------SSSSSSSSSSS-----------------###--------S!S--S@S--------SCSSS----#----------######---------
-------K-------------------------------------#--------#---#-------------TT---------------------------------####--------------------------K-----##---------#######---------
-----------------#---------------------------#--------#---##------------TT--------------------------------#####--------------------------------##--------########--------F
--M------------kk#----------------------ggg--#--------#---##--gg----k---TT--------------K----------------######------k------ggg--------K---K---##-------#########--------#
XXXXXXXXXXXXXXXXXXXXXXXXXXXX------XXXXXXXXXX-X--------X---XXXXXXXXXXXXXXXXXXXXXXXXXXXXXXXXXXXXXXX----XXXXXXXXXX--XXXXXXXXXXXXXXXXXXXXXXXXXXXXXXXX---XXXXXXXXXXXXXXXXXXXXXX
XXXXXXXXXXXXXXXXXXXXXXXXXXXX------XXXXXXXXXX-X--------X---XXXXXXXXXXXXXXXXXXXXXXXXXXXXXXXXXXXXXXX----XXXXXXXXXX--XXXXXXXXXXXXXXXXXXXXXXXXXXXXXXXX---XXXXXXXXXXXXXXXXXXXXXX
