---------------------------------------------------------------------------------------------------------------------------------------S--------------
-----------------------------------------------------------------------------S---------------S----------!-S-------------------------------------------
-------------------------------------------------------------------------------------------------------------------------------X---------------S----#-
------------------------------------------------------------------------------------------------------------------!------T----------------------------
-------------------------------------!-------------------------------------------------------------------------t----------!------------T------------T-
-------------------------U---------S------------------------------------------------------------------------------------St----TT----#------------k----
-----------------------------------------!-----t--------S-S-------------2-------------------------#S---##------T------tt#t----#---------g---------g---
---------------------------------S-------S------S-------------------------T----------------g-----T-----TX#X#--k---g-X--XX-----#--XXXXXXXXXXXXXXXXXXXXX
----------------------------------------------------------g------------M---------------tXXXXXkXXXXXkXXXXXXXXX-XXXXXXXXXXXXXXXXXXXXXX-XXXXXXXXXXXXXXXXX
-----------!-----------------------#---#--------T!--t-#-------g-------Tt--X---X----XXXXXXXXXXXXXXXXXXXXXX-XXX-XXXXX--XXXXXXXXXXX----------------------
-------S---------------------------T-------------------------g##----gKXXXXXXXXXXXXXXXXXXX-----X--XXX--------------------------------------------------
-------T-----------t---------T----#------------t-----------XXXXXXXXXXXXXXXXXXXXXX---------------------------------------------------------------------
---------------T-Xk-------X--#F---g-#----------#TXXXXXXXXXXXXXXXXX-X---X------------------------------------------------------------------------------
-------t#-X---X-XXXXXXXXXXXXXXXXXXXXXXXXXXXXXXXXXXXXXXX-#XX-------------------------------------------------------------------------------------------
XXXXXXXXXXXXXXXXXXX---XXXXXXXXXXXXXXXXXXXXXX--XX----------------------------------------------------------------------------------------S-----------C-
XXXXXXXX--XX--X------X--------------------------------------------------------------------------------------------------------------------------------
