------------X-----------------------------------------------------------------------------------------------------------------------------------SS----
---------------------------------------------------------------------------SS-------------------------------------------------------------------------
----------------------------------------------------------------------------------------------------------------C-!-----------------------------------
----------------!---------------|-----------------------------S-----------------------------------------------S---------------------------------------
--------------------------------------------------------------S--------------------------------------------------------------------------------C------
--------------------------------------------------------------------S---------------------------S---#-------S-----------------------------------------
-------------------------S---------------------------------------#------#X-----------S----------------------------------S-----S---------#-------#-----
-------S--------------------------!-----------------T----#----!-------------S------------------------------------#--------------S--------F------------
---------------------------------------#---T------------#---T-------------#---------------------#--#--S----!-g-----------------#---------T!!-S---#--t#
--------------------------S--------------------gg---!---#-----------t---!--#------2--------#---------g------------##S----##-----T--------X-------#----
--------t!--#------#-------------------t--------X-#----t-X-------------#C---g------S------#-t#--#--XXX---L-t--#--##T----SCS--#-g@#------------XXXXXXXX
--------T##-!#-g-----T--Tt!---Xt-----T--Xg----g--XXX#X--XXX-XXkXXX---C------------#--t---------TXXXXXXXXXXX--XXt-T------#T--X------X--#--CXXXXXXXXXXXX
------M#-------t---------#--g--X--X#XC-XXXXXXX-XXXXXXXXXXXXX-XXXXXXXXX-#-------|-T-t-##-Tt-XX-XXXXXXXXXXXXXXXXXXXXXXg--XXXXXXXXXXXXXXXXXXXXXXXX-------
---------t----t--!Y--#-XXXXXXXXXXXXXX-XXXXXXXX--XXX--X----------XXXXXXXXXXX--XXXXXXXXXXXX#XXXXXXX-X------XXXXXXXXXXTX-X-XX--XXXXXXXXXXXXX-------------
XXXXXXXXXXXXXXXXXXX-XXXXXXX-XXXXX-XXX------------------------------XX-XXXXXXXXXXXXXXXXXXXXXX----------------------XXX--XX--X--------------------------
XXXXXXXXXXXXXXXXXXXXXXX-#XXX-----X------C-----------------------------------XX------------------------------------------------------------------------
