----T------------o---------XX-XX-g#-T-------C-------g--------#---LT-----t-----S------S--#----------------#----------t-------!-------------S-XT-T----t-
-------X-------------------X--X-XXXXX-T--#---t--#-g--T------CC------XTT--#-#----------Xt----------#-X---T---!--------S--!#---!----------t-----#T---tt-
---------------------X-------XXXXXX-XXMXt#--T-X--#--XX-------T---#-XTT@!----XXg-----U----X------------#---S#CX--X--gX##t-#-------r--T--Xt-XXXXXX-T-tXX
----------------S------------------XXX--XXX#-X-g-XX-TX-XX-X-#L-#XX#gXXXXXtX-X-XXXXXXXX-X#----#tXX#-t-X-#-gXX#-XXtXXXFXXXSXX-XXT#-----XXtXX--X-XXX-@XtX
------------------------------T-----X-#--XTX#XXXXXX---XX--SXX#--XXXXXXXXX--XXXXX-XX-X-XX-XXXXXXXXXXXXXXXXXXXXt-X-XXXXXXXXXX--X--X-X#gXXXXX-X-T-XXXX-XX
---------------------------------------------XXXX-XXXX-X-XX-XXXXXXXX------gXX-X--T------XXXXX--XX-X-XXX-X-X!-X--XgX--XXG-XXXXXXXXXXXXXKX----------X--X
---------------------------------------------X--X-----X----XXX-XX-----------------------X---------------------------------------XXX#-X----------------
------------------------X--------------t--X-------------------X----------T------------X--------------------------------------------X------------------
----------------------------------------------------------T--------------------S----------------------------------------------------------------------
------------------g-----2------------S----------------------------------------------------g---------------------------|---T-----------------X---------
-----X-1-----t#----------------------k-----------------------------------------------------------------------------------------S----------------------
---------##--X-!---#-------L----#-----------------------@-------------#-----X------------------------------------------------------------------S------
-------M----X-TXXX-tX#---#XTS---------------T--------------------------------------------------------------------------g----------S---------------#-!-
----#-----#X--XXXX#X#X-t-XX----X------------------------------------------------------------S-----------------S------------------------------S--------
XXXX-T-XX--XX-XXXXXXXXX-XXXXXXX--------------#----S-K------------t--!DS-------t----------------------------------------------------S------------------
XXXXX---XXXXXX-X-SX-XXt---XXXXXX------t-!--S------------#------------------------#X-------------L------------------------T-S--------------------------
