-------------------------------------------------------------------------------------------------------------------------------------------------------------------------------------------------------------------------------------------------------------------------------------------------------------------------------------k---------------------------------------k---------
---------------------------------------------------------------------------------------------------------------------------------------------------------------------------------------------------------------------------------------------------------------------------------------------SS!SSS@SSS--------SSC------------------S!S--S!S--------------------------------##---------
----------------------------------------------------------------------------------------------------------------------------------------U----------------------------------------------------------------------------------------------------------------------------------------------------------------------------------------------------------------------------------###---------
------------------------------------------------------------------------------------------------------------------------------------------------------------------------------------------------------------------------------------------!------------------------------------------y------------------------------------g#---------------------------------#-----------k####---------
-------------------------------------------------------------------------------------------------------------------------------------------------------------------------------------------------------------------------------------------------------------------------------------X---------K---------------SSS-------g##---------------------------k-----#-----------#####---------
-------------------------------------------------------------------------------------------------------------------------------------------------------------------------------------------------------------------------------------------------------------------------------------X-------SSSSSSSSSSS-----------------###--------S!S--S@S--------SCSSS----#----------######---------
--------------------------------------------------------------------------SUS-------------------------------------------------------------------------------------------------------------------------------------------------------------------------------------------------------XX----------------------------------####--------------------------K-----##---------#######---------
------------------------------------------------------------------------------------------------------------------------------------------------------------------------------------------------------------------------------------!---S@S!S---------------------tt---------------XXX---------------------------------#####--------------------------------##--------########--------F
----------------------------------------------------------------------------------------------------------------------------------------------------------------------------------------------------------------------------------------------------------tt------tt---------------XXX---------------K----------------######------k------ggg--------K---K---##-------#########--------#
--------------------------------------------------------------------------------------------------------------------------------------------------------------------------#-------------------------------------------------*-------------------tt--------tt------tt-----------g-g-XXXXXXXXXXXXXXXXXXXXXXXXXXX----XXXXXXXXXX--XXXXXXXXXXXXXXXXXXXXXXXXXXXXXXXX---XXXXXXXXXXXXXXXXXXXXXX
-------------------------------------------------------------------------#####-----------------------------------------------------#LSS------------------------------*----#----------------------------------#---------X----*------------g------tt--------tt-g----tt-----g-g-XXXXXXXXXXXXXXXXXXXXXXXXXXXXXXXXX----XXXXXXXXXX--XXXXXXXXXXXXXXXXXXXXXXXXXXXXXXXX---XXXXXXXXXXXXXXXXXXXXXX
-------K--------------------TT-----TT----K-------------------------------#--------------------------#------------------------------#--------------ggg---------ggg----*----#----ggg--k----ggg-----------kk--kk#--------gXXXXXXXXXXXXXXXXXXXXXXXXXXXXXXXXXXXXXXXXXXXXXXXXXXXXXXXXXXXXX---------------------------------------------------------------------------------------------------
----------------------------TT-----TT-----------------------------------K#---------------------*----#------------------------------#--------XXXXXXXXXXXXXXXXXXXXXXXXXXXX--XXXXXXXXXXXXXXXXXXXXXXXXXXXXXXXXXXXXXXXXXXXXXXXXXXXXXXXXXXXXXXXXXXXXXXXXXXXXXXXXXXXXXXXXXXXXXXXXXXXX---------------------------------------------------------------------------------------------------------
--M-----------ggg---------kkTT-----TT-----------ggg-------ggg------------#--------------ggg----*----#----ggg--k----ggg-----------kk#----X---XXXXXXXXXXXXXXXXXXXXXXXXXXXX--XXXXXXXXXXXXXXXXXXXXXXXXXXXXXXXXXXXXXXXXXXXXXX---------------------------------------------------------------------------------------------------------------------------------------------------------------
XXXXXXXXXXXXXXXXXXXXXXXXXXXXXXXXX--XXXXXXXXXXXXXXXXXXXXXXXXXXXXXXXXXXXXXXXXX----XXXXXXXXXXXXXXXXXX--XXXXXXXXXXXXXXXXXXXXXXXXXXXXXXXXXXXXX----------------------------------------------------------------------------------------------------------------------------------------------------------------------------------------------------------------------------------------------
XXXXXXXXXXXXXXXXXXXXXXXXXXXXXXXXX--XXXXXXXXXXXXXXXXXXXXXXXXXXXXXXXXXXXXXXXXX----XXXXXXXXXXXXXXXXXX--XXXXXXXXXXXXXXXXXXXXXXXXXXXXXXXXXXXX-----------------------------------------------------------------------------------------------------------------------------------------------------------------------------------------------------------------------------------------------
