---------------------------------------------------------------------------------------------------------------------------------------------------------------------------------------------------------------------------------------------------XXXXXXXX--XX-
---------------------------------------------------------------------------------------------------------------------------------------------------------------------------------------------------------------------------------------------------XXXXXXXX--XX-
----------------------------------------------------------------------------------------------------------------------------------------------------------------------------------------------------------------------------------------------------------------
----------------------------------------------------------------------------------------------------------------------------------------------------------------------------------------------------------------------------------------------------------------
----------------------------------------------------------------------------------------------------------------------------------------------------------------------------------------------------------------------------------------------------------------
----------------------------------------------------------------------------------------------------------------------------------------oo-----------------------------------------------------------------------------k----------------------------------------
------------------------------------------------------------------------------------------------------------------------------------------------------------!------------------SS!SSS@SSS--------SSC------------------S!S--S!S----------------------------------
----------------------------------------------------------------------------------------------------------------------------------------------------------------------------------------------------------------------------------------------------------------
------------------------------------------------------------------------------------------------------------------------------------------------------------------------------------------------------------g#---------------------------------#----------------
-------------------------------------------------------------------------------------------o---------------1--------o--------o---------------------------------------------------K---------------SSS-------g##---------------------------k-----#-S--------------
--------------------------------------------------------------TT---------------------------------------TT----------------TT--------TT-----------------!---S@S!S--------TT------SSSSSSSSSSS-----------------###--------S!S--S@S--------SCSSS----#S---------------
-------K--------------------TT-----TT----K--------------------TT---------------------------------------TT----TT----------TT--------TT----------------------------------TT---------------------------------####--------------------------K-----##----SSSSSSU-----
----------------------------TT-----TT-------------------------TT---------------------------------------TT----TT----------TT--------TT---------*------------------------TT--------------------------------#####--------------------------------##----------------
--M-----------ggg---------kkTT-----TT-----------ggg-------ggg-TT----k-k---------------k---------ggg----TT---kTT----------TT--------TT---ggX---*------------g-------k---TT--------------K----------------######------k------ggg--------K---K---##----------------
XXXXXXXXXXXXXXXXXXXXXXXXXXXXXXXXX--XXXXXXXXXXXXXXXXXXXXXXXXXXXXXXXXXXXXXX-X-XX-XX-XX-XXXXXXXXXXXXXXXXXXXXXXXXXXXXXXXXXXXXXXXXXXXXXXXXXXXXXXXXXXXXXXXXXXXXXXXXXXXXXXXXXXXXXXXXXXXXXXXXXXXXXXXXXXX----XXXXXXXXXX--XXXXXXXXXXXXXXXXXXXXXXXXXXXXXXXX----------------
XXXXXXXXXXXXXXXXXXXXXXXXXXXXXXXXX--XXXXXXXXXXXXXXXXXXXXXXXXXXXXXXXXXXXXXX-X-XX-XX-XX-XXXXXXXXXXXXXXXXXXXXXXXXXXXXXXXXXXXXXXXXXXXXXXXXXXXXXXXXXXXXXXXXXXXXXXXXXXXXXXXXXXXXXXXXXXXXXXXXXXXXXXXXXXX----XXXXXXXXXX--XXXXXXXXXXXXXXXXXXXXXXXXXXXXXXXX------r--------F
