--------------------------------------------------------------------------------------------------------------------------------------------------------------------------------------------------------------------------------------------
--------------------------------------------------------------------------------------------------------------------------------------------------------------------------------------------------------------------------------------------
--------------------------------------------------------------------------------------------------------------------------------------------------------------------------------------------------------------------------------------------
--------------------------------------------------------------------------------------------------------------------------------------------------------------------------------------------------------------------------------------------
--------------------------------------------------------------------------------------------------------------------------------------------------------------------------------------------------------------------------------------------
--------------------------------------------------------------------------------------------------------------------------------------------------------------------------------------------------------------------------------------------
---------------------------------------------------------------------------------------------------------------------------------------------------------------------------------------------------------------------------------##---------
---------------------------------------------------------------------------------------------------------------------------------------------------------------------------------------------------------------------------------##---------
--------------------------------------------------------------------------#---------------------------------------------------------------------------------------------------------------------TT-------------------------------##---------
-------------------------------------------------------------------------##--oo------o----o-------------------oo---oo--------------------------------X------------------------------------------TT------------------------K---#--##---------
------------------------------------------------------------------------###--------------------------------------------------------------------------X---------------------------------#LSS-----##---------------------------##--##---------
-------K--------------------TT-----TT----K-----------------------------####---------------------------------------------------------------TT------------#------------------------------#------------------------------------###--##---------
----------------------------TT-----TT---------------------------------#####----------------------#---#------------------------------------TT------------#------------------------------#-----------*---TT-----*------------####------------F
--M-----------ggg---------kkTT-----TT-----------ggg-------ggg------gg######--k-------------------#-k-#-----------------------k------kkk---TT------------#----ggg--k----ggg-----------kk#-----------*---TT-----*-----K-----#####------------#
XXXXXXXXXXXXXXXXXXXXXXXXXXXXXXXXX--XXXXXXXXXXXXXXXXXXXXXXXXXXXXXXXXXXXXXXXXXXXXXXXXX---XX---XXXXXXXXXXXXXXXX-----X----XXXXXXXXXXXXXXXXXXXXXXXXXXXXXXXX--XXXXXXXXXXXXXXXXXXXXXXXXXXXXXXXXXXXX---XXXXXXXXXXXXXXXXXXXXXXXXXXXXXXXXXXXXXXXXXXXXX
XXXXXXXXXXXXXXXXXXXXXXXXXXXXXXXXX--XXXXXXXXXXXXXXXXXXXXXXXXXXXXXXXXXXXXXXXXXXXXXXXXX---XX---XXXXXXXXXXXXXXXX-----X----XXXXXXXXXXXXXXXXXXXXXXXXXXXXXXXX--XXXXXXXXXXXXXXXXXXXXXXXXXXXXXXXXXXXX---XXXXXXXXXXXXXXXXXXXXXXXXXXXXXXXXXXXXXXXXXXXXX
