-------#-------%-----T--To-------------------------XS-------S--------X-S--------!----SX|X-----X---X-----XX-----------%X------#--------------X-----------|%X------X----------------------%g---S---X-------X--------------------S------X---S-------X----------o----S---
---------------------------------XS--|T------T-X-#----------------X-----X-|----S----X-X----|----XX-----g---T-------X-S--------------------XX---T-X--------------------S-----X-------X---S-------|-S-----S--t------------XXX---#|-X-X--------------|------B|---T------
-----X----X--X----S---X--#S-----X--------X-X----------------X------SX-|T----S-X--o----------XX------S---X--XX------t-S-------------XS-------------------o----T---#---g----------------X|#-----S--XS-#-S------X---S----T----X-X#---X-------%--X--S--------X--X-g-X-rXF
------------S-#------------------------XX-------------1-------X-----------k--------------X------#------------#-K----SX------------X------X-----------------XX-|-S--XX--X---X-------------------C------X------X-#----X---------XX---X|---#---bX-----|-----------------
-----------X------SX--S---------X-----------------!-|-X--X--TX-----XX---X-------X--X------------------X---S-------SXX---#-X----X-X-------X--X----T--#-----------X----------------------X-X---------X---------#-------X-----X----X---X----------------------T-X-X----|
------------X-----X--X--------X------------X----X-------------------XX---X---------g-----gX-------------------X--|#X--XX---X#S-----X----------------X---X-------------X--------#----------------------------X------#---X----X------X------S--X-----------------------
--------X----------#-k------------------X---X-------------T-----S-------X--------X--%-------------XXX-------------------S-----#---o-------------X--X-g---X-------------X--X--X------XX-X---------------X-----XT---X---X-|--o-------------X---------T---|--#T----X----
------X---SX--%X-----#--k---X-----|----X----X-----#-----X-------------X------X-------|-------o----------%--------X----#---------------|--#--------------S%---X---X-|------T-#TX---X---#-X-X-##------------X--X-------------S---T---XX-------S|-----------k#-------K--
--------S-------X-T------------XX--|---SX-----S-----XS-X----------S-------X----X--X---X------------X---X--------S--------------X---------X-X---X------#------------|--------------|X-------g---X-------XX-------------X--T-X--X---X--X---S-----X------X-|------------
------------T--X--!---------X-----------o----X--#---T---------%----------%--S-----X-----S---X-X---------S-------#-------X----X-T---------X--X---T-----XX------X---X-o-#------------#---------S--------------ST-------XX---X--#----------------S--|-%-X---X-|------t--
---------#!----------------------g---tXX-----XX--S--X------------------X--------X-S----------------X---X------X----#----XtX---X-X#----S-%--X---Xt----------X---%---X--S-X-----XX-------------#------||---ST--X--------X----X--X---#-------XT-----X----------ST-g-X---
-------X------X-------X-k-------------X-----X|--------X---------M--SXX-------------|----------XX|----S-S-------X-----------S----------U----|-----XS---X--------X-#X-X----------S---------X-X---------%----T-------|----------X----------X------#---------X--X-T-----S
-----X-S------X--%-XX----|---|----X--SXX|---%--Xk-S----------------X------------------SX-------X------%--XXX--T-----Xk--X-XX------------------#-S----------X----#------S-----#-----X-----------XX-----X-------X----X|!--!X---X---S--#-------|---X-|----X------S-----X
--M---S-----k---------------------X-------X---|-----------------X-------------X----------XS-------X-XT------------b--|-S-----#--X-------X-------X-X----X-#--X--XX------X-SX-----------------------------X---|-----------------T-X--#-----------#X---S-X---X-|--------
XXXX----X----Xt---------S---X-X--------gS---------TX---------SX---#--#X-X-----------------X----X--S---X---X------XX%--------X--X---X-----|--X--X#S-t-%-X-X-----------------------------X----------X------X--------------------------------X-XX------X-----X----X-o---
XXXX--------|--X------t-XX----S---XX--X------------XX--T--|-X----X-X---X-X-------------X-------------X--%-kX-----o-----|--------------X-----%-------S----XXT--------X---#---X--X------------o------t-------------X---XX-S-X------S---X-------X--|----------X---X-#S--
