------|------X-------B-X----g--X--|------
----------------X----------Xo--|------X--
--------|X-------------------S|-k#-------
----#-o-----X--%------o---------X----X---
------------S------X--------X|--------|--
-------|-X----|-------XX------S----------
------------#----------X|-t---X-X-X------
---------|S------#-#---------------------
----------X------U--------XSS----------S-
----#--#----r-------X--STXX-----------X--
------------%----%--------T--------------
---------X---Xg-------X-----------------F
-------X-----------------------X----XS--o
--M-------------------X-------X-----SX---
XXXX-----X-----------|--------X-----X#--S
XXXX----X--------X-------g-----S-----TXX-
