--------------Xy------X---o------------------X---S--------------XX---X-X----X-X----T----X---#X----X------------------og-XX-o-#-----X----|--X------X-|SX----X--------X---S--------X-%---S-X---X-T---------------XX---
--------------X--X-----X---X--S----X----X-----#--------%-------%--|---UX--XX-----------------X------|-------X-----%--------t---X----|-------%----S----XS-X-----XX--|-|---X-------X--t----S-S--XX-------X--------T---
-------b-XS--------o----|------k---X--T------------X-----X-XSX-X---tS------TX-----X---XX---------%-X----#-#-----X-------------#--#-------S----------#-------T--------X-X---S-X---g--S--X-S----||---|-X-X--BXX-------
----X------X----X-----T-------------------T---------SS------------T----------------X-X-----X---------X---SX---------------------------X----------------------------#----X----S-X--X---------------#-----------------
------X------t------X----------------X------------#--X-------------|---S-X---#------#------------------------X-----X----#-|-----------|X-X----X---X----X----X--------X---X------------------------T------------X----
----XS-t---X----------------T-------------S-----X--XXX-X-S--X-S-------X-X-X----!---------X--X---------|X-----#----X----X-X-----C--o---X-S---#---X%X#------X--------%-X----X---X---X--------------T-X---------X-X-SXF
-------S---------X------##------------#------|-X--#-------X---X-------------------X-----X-----------------X------S-------|---BX--|-------XX-------X--X---|X|---------X--------------------#-g--------------C--S-%---
-----X------------#X--|-------------X----S--%----X-X----|----X-----X-SX------#--------X-----X--C---X----X-------X--#-------X------T--------X--|#------X-#S-------XX-@-----------S---X--#-#------#S-------X----|-----
-------X%-##-X-------X---|---X-------X-X---|----X---X--XX----X-------#--X-------Xo-S---T-X-------------X-X---#X--#-------X-----T-SS----B--XX------S|---|-o----------X-X------X------|X-X---|XX-SS2X-TXX-----|-------
----X---S--------------#---X-------X-S-----XX---X-X---#---XX----#------X---------X-------XX--------|-T--------------X-------------X----X---X--#-!-------------------------#r--------------#----%---T--X---X---X-----
------X-----#X---T------|--#|----S-#--o----------X-------|--!-X|-------TX------X----%#-XX---r--X-----Xt-r---%---------X------S#--S--%X---------------X-------|----------#--X--------------------T-----X-------------
----------S----X--MX-------SXX----------X--%---T-----X-XX----------X-----------------X--X---TX------------o-XX-------------K--------TX---X--X----X--XXXX-%----X|--S-X------|--------X-XXT-------------------g--X---#
--------#----X-----------------S-------X--t-----X----X----X----X---X--XX-X-X-----X-X-------------|--Xt---------#-------X-----X--|--------XX--X--#-X------X-----X-------X----------------o---#X---------------X---#kT
--M-----------X----#---XXST------X-|---------T---------------X--|T#-----------X------X----X-------------------------XX--XX---S----%---T-X-----------------------X---X|--S-----S----|X----X----X----XX------X----#---
XXXXS----------X---X--X--S----------X----S----#-----X--X------X%---%-S---------X-X--t-------X---X------X----X------X---X-----T--X-U----X-----K-------X#--------------X---S----X-------X-X-------------#-SX---ok----#
XXXX#----X--------X--X---X-----#X-SS----X-----X---k--X-X----------S-SX-X-X-X--|-----------XS#X-X----X----X-----------X----X-----o#-#--------------X----S-X---X---X-------X------------------X-----#-----o------X----
