--------X--X---|---|------S------------X-----X-S---X----------X---------------X---------S-----------------X------t------X-----------------XTX-----------X-----------#T-X-|-#k-------T1--X---S----TX---------#----------------X#----S--XXX-----#--oX-----|X---X-X---X-XX--------X---X----
----#---------XX------------XX-------S-------|------#-----TX-------S------X----X-X--------------T----XX---------X-X--------X#X-----XX-U------------|--------X-#---X------#----S|----X-X-|--X--#------------X---------------X-XS||----------Xt----T----X--#XXX-X---S-T-X--XB----S----X---
---------X----------------#--------|--X-X--g--X--X#-----X-----|----------X-----------T-----TX---------S-X---------oS--------T--------#---X------T-T----------#-SBX--XX--#---X--------X--X-X-----X------X---------X--X---------------X------------X-X--T--------#---------------------X-F
----X------------X---#--o--------X-------X-X---------SSX---T------------X--X---T-#-X-TXX#X-----------#----o---XXX---X-X-------S--S----X-X--X------------------|------------S#--S-X-X---g-----X------------X------X-X----X#----X----|X---X-----X-----S--X-----------|-----X-|--X---|---T-
-------X---XX-----g--------T-X|--X---#--X-----------X--X---X--X--------------------X--S-------------X----------------o-TX#----S----#---------#------------#---S#-XS--##----|----X-#--------T-----------X--S-------S-X----o--#X-#S---|----S------XXBg-----------X------T--X------------TX
----------S--------------X--X|#----X----------------X--S--X--------S-X---T--------|------!|-X----X--XX-----------X-------X-----%--%X-%-X---T---|----X--X-o----S-------o-------------------------S-----|C----X----------|--------#-------------X----Xb--g-X------X------o---X---B----X---
----------------#-----#------------#X-XX--X-|--X-S---X--------|X------X--X---------------S-%-----#--T---|----X|-------------o---XSX-g----------g-------X-------X----XX--------S---X--------#---------T----T-#--------------------------------------S!--X---------X----#-----------X--KX-
--------XS-----X-X----|----X---S-------------X----g-----X----------X----SX-|----U-------|------------------X--------------X-------X-----------#X------K--|--X-----S-X-------X-|---X---|-------------------|-----X---X---X--#TX-X--------X-X-X#-----TX----X------X-X--X------%X-------X--
----X#---------B------------X----------#-XX-XXX----X-------|-X----X--X-----------------ST-----S----S-------X------X--------------------X--------T-X------X-X--XX------X----------X---g--------------X-X-X--X----------X--------------------X--X--X--X-----X-----#S#---------S-------X---
----#X---X-X-------#--S------|---X#X------X-X-T----------------T-X-----X-X-------X----!-----X----S-X-X-------X--XS--C---X--------X-S#--X--------X#--XX--------|-|-g------------X-|--X-------X------X--X%-----S--X-------S-X----S------S-S-------X-S---X---------X-----o--XX-X-#----X----
-----------X---------X--X-----------------X--X|#-X---X---S----X-o------X---o----X---------XXX------X------------X-X------------|X--------#S--------------X-----X---S--#---S-----------------SX---X----X---T-----------------%----TX---X---------X|-X---S--------X----S---@----XX--|--|--
-------|--------X--------------k@-----X--X------X------%--XX-|-----------------X!-----X---X----S#--S-------------o------#-----o--XX--|---------!S-S-------------X---------X------X-----o---------------|-----------S--X--------X---S------X-----XX--|-------X|----X--X-XX------X---#----
-----S---------------X----X--------T---B-----------------X--------XXX--------X-#-B--X--XXS---X------X-----|--------------T------------X---X--S--X-X--------#--X---X--T-------------#--X------X--#---o--------------------------------X--t----#-|S-X-|--S-----XX--#---------X------------
--M--------------X-S#-------X-------X--X----X--X----X-----------U-------X#---X-----S------X--------|-------------X--------------T--X-X--X--------XS----------------#------------o--#-------------#|y---XX----%-|-#|------------------|----|--X---Tk--X------X---------------------------
XXXX-#--S-%---kX----S-----X-------------------S----#--X--X--------X------X-k------------------------------X-------X--#--Xo----------XX----#-------------X------X@----------------------------------X-----S--S---X-X|------X----S----%---X-#-------------%--------------X----------------
XXXX|------X-----S-------X-------b---------XX|--X--#-----------o--------#-------------------------------X---X--------------yX-----------X---------T---X-SS--------------X----------------#--XT---X----------------|----X----------------|X----X-----------X-X--------X-------S-----XXXXX
