----|--------------|||||-----|----||%---%-------||||||||---||||||||--|||---|||||||------||------||-----|||||--||--%%%--------------------------------#
-------------------||%||-%%--|----|||---|-------||||||||---||||||||--|||---||--||%------||------||-----|||||--||--||--------------------------------##
-------------------|||||-|---|--%%%||---|-------||||||||---|||||||--o------||--|||--------------||-----||-----||---|-------------------------------###
---------------%---|||||%|-------||||%--|----%%-||||||||------------------------------------------------------------------------------------------####
-------------------|||||------------||%-|%--%|-----------------------------------------------------------------------------o---------------------#####
----------------%%%%||||------------||%%|----|--------------------------------------------------------------------------------------------b------#####
----------SS----|-||||||--------------|-|-------------------------------------%-----------------------------------------------------------*-g-k--#####
------------S---------------------------|-----------------------------%%%----%-----------o------------S--------------------------XXXXXXXXXXXXXXX-XXXXX
-----------------------------o---------------------gg---%------------%|||--o-----o-------%--SS-------S--------o------------------XXXXXXXXXXXXXXX-XXXXX
-----------------------------------o-------------%%%%o-g|-S-----------|||---%--oo%------R|%----S--------------------------SS--------------------------
----------------------------------%%g------------||||%-%|-------------|||%-----%%|%------||%----------------------------------------------------------
-------------S--oo------------1----|%o-------%---|||||%||%------------|||----%%||||------||---------------------------------S-------------------------
-----r----------SSSo--o------------||%---%o------||||||||-------------|||------||||------||-----------------------------------------------------------
%%%%-%%%%%---------%%-%%-%---------|||%---------%||||||||--%----------|||--%---|%%|------||-----%--------ro------------------SS-----------------------
-||-%||||-----------|%||%----------|%|--%--------||||%|||----%%%%-----|||---%%-||||%-----||------%------%%%%%%----------------------------------------
-||--||||-----------|||||----%%%---|||-----------%|||||||---%X|||%%%%-|||---||%%|||-----%%|------|%%---%|||||-%%%%-------------S----------------------
