--------------------------------------------------------------------------------------------
--------------------------------------------------------------------------------------------
--------------------------------------------------------------------------------------------
--------------------------------------------------------------------------------------------
--------------------------------------------------------------------------------------------
--------------------------------------------------------------------------------------------
---------------------------------------------------------------------------------##---------
---------------------------------------------------------------------------------##---------
-------------------------------------------------------------------------------#-##---------
-----------------------------oo-----oo-----------------------------------------#-##---------
-----------------------------------------------------------------------------#-#-##---------
-------K---------------------------------------------------TT----------------#-#-##---------
---------------#-------------------------------------------TT---------TT---#-#-#-##--------F
--M----------kk#------------------------------k------kkk---TT---------TT---#-#-#-##--------#
XXXXXXXXXXXXXXXXXXXXXXXXXXX------XX----XXXXXXXXXXXXXXXXXXXXXXXXXXXXXXXXXXX-X-X-X-XXXXXXXXXXX
XXXXXXXXXXXXXXXXXXXXXXXXXXX------XX----XXXXXXXXXXXXXXXXXXXXXXXXXXXXXXXXXXX-X-X-X-XXXXXXXXXXX
