-------------|||||||||----------|--------%----------||------------------XXXX----------------kgttttgM-----y-------#-----T------TT------gtt----------g--
--------%----|||||||||-------%--|-------r-%---------||--r---------------XXXX------------XXXXXXXXXXXXXXXXXXX---XXXXXXXX-X%--XXXXXXXXXXXXXXXXXXX-XXXXXXX
---------%%%-||||||||%----------|-----%%%-|%%----%%-||%%%%%%%%--------------------------XXXXXXXXXXXXXXXXXXX---XXXXXXXX-X---XXXXXXXXXXXXXXXXXXX-XXXXXXX
---------||--|||||||||-%--------|--%%%||--||--%%%|--|%||||||||%---------------------------------------------------------------------------------------
------------------------%%%%----|---||----||---|||--||||||||||----------------------------------------------------------------------------------------
------o-----------------||||%%%%%%--||----||--------||||||||||----------------------------------------------------------------------------------------
-----o----------------%-|||||-|||-------------------||||||||||----------------------------------------------------------------------------------------
------SS----------------|||||-------------------------------------------------------------------------------------------------------------------------
------------------g-----------------------------------------------------------------------------------------------------------------------------------
----------o-------%%|------------------------------------------------------------------------------------------------------S--------------------------
----------------%%|||%---------------------------%----------------------------------S-------------------------------------o---------------------------
-------------%%%||||||----------------------------------------------------------SS--------------------------------------------------------------------
--------------||||||||%-----------------------------%-------------------------------------------------------------------------------------------------
%%%%----------|||||||||-------------------------------------------------------------------------------------------------T------------S----------------
-||-----------|||||||||--------------%----------------%--------o--------------------------------------------------------T------TT---------------------
-||-----------|||||||||---------%%-------------------%|----------------------------------------tttt---------------F-----T------TT-------tt------------
