----------------------------------|||||--------------|---|---||------||||||||-------------%-----------||-----------------r---#######--------F----X----
----------------------------------|||||--------------|---|---||---oo-||||||||--------------%%%--------||-------%%%--XXXXXXXXXXXXXXX#--------#----X----
-----------------------------r----|||||--------------|---|---||--%%%-|---------------------||---------||--------|---XXXXXXXXXXXXXXXXXXXXXXXXXXXXX-----
-----------------------------%----|||||------------%-|-r-|---|%%--|------------------------||---------||--------|------------------XXXXXXXXXXXXXX-----
-----------------------------|-r--|||||----SSS------%%%%%%%%%%|--------------------SSSS----||---------||--------|-------------------------------------
-------------------------%%%%|%%%-|||||-------------||||||||||-----------------------------||---------||--%%%%%-|-------------------------------------
--------------------------||||||-----------------------------------------------------------||-------%%%%%--|||--|-------------------------------------
--------------------------|||%||--------------------------------------o----------------SSSS----------|||----------------------------------------------
---------------------%%%%%||||||----------------------------------------------------------------------------------------------------------------------
----------------------|||-||||||------------------------------------R----------------------------%%%------------------------------#-------------------
----------------------|||-||||||------g-g-------SSSS----------ooo--R----------SSS-----------------|-------------------------------###----------------X
---------------%%%%---|||-||||||--%%%%%%%--------------------%%%%---------------------------------------------------------------#####----------------X
----------------||----|||-||||||---|||||-------------%--------||-------r-r----------------------------------------------SSS-----#####---------------X-
----------------||-----------------|||||--------------o---o---||-----%%%%%%%%%%-----------------------oooo--------------------#######---------------X-
XXXXXXXXXXXXX----------------------|||||--------------%%-%%%--||------||||||||--------------o---------%%%%--------------------#######--------------X--
XXXXXXXXXXXXX----------------------|||||--------------|---|---||--o---||||||||-------------------------||---------------------#######--------------X--
