----------------------------------------------------------------------------------------------------------------------------------
----------------------------------------------------------------------------------------------------------------------------------
----------------------------------------------------------------------------------------------------------------------------------
----------------------------------------------------------------------------------------------------------------------------------
----------------------------------------------------------------------------------------------------------------------------------
------------------------------------------------------------------------------------------------------------------------k---------
------------------------------------------------------SSSSCSSS---------------------------------------------------------##---------
--------------------------------------ooo-----------------------------------------------------------------------------###---------
---------------------------------------------------------------------------------------------------------------------####---------
------------------------------------------------------------------------------------SSUSSSSS------------------------#####---------
-----------------------------------TT----------------#----2----#---------------------------------------------------######---------
-------K--------------------TT-----TT----------------#------K--#-------K------------------------------------------#######---------
----------------------------TT-----TT----------------#---------#-----------K-------------------------------------########--------F
--M-----------ggg---------kkTT-----TT-----------ggg--#---------#------------------------------------------kkk---#########--------#
XXXXXXXXXXXXXXXXXXXXXXXXXXXXXXXXX--XXXXXXXXXXXXXXXXXXXXXXXXXXXXXXXXXX-X-XX-X-XX-XXXXXXXXXXXXXXXXX-X-XXXXXXXXXXXXXXXXXXXXXXXXXXXXXX
XXXXXXXXXXXXXXXXXXXXXXXXXXXXXXXXX--XXXXXXXXXXXXXXXXXXXXXXXXXXXXXXXXXX-X-XX-X-XX-XXXXXXXXXXXXXXXXX-X-XXXXXXXXXXXXXXXXXXXXXXXXXXXXXX
