------------------------T-T-LSSS-SSS--SSUS-S---------------|-------%------%-----%---|||-------%-------|||--SLSSSS-S--o--S-SSSSSSSSSSSSSS--SS----------
-----------------------TTTT-----XXXXXXXXXXXX---------------|---------%---------%---%-------%--|-------|||---------S-----S-SSSSSS----------------S-----
----------------------TTTTT-----XXXXXXXXXXXX--------------%|---------|---------|---|-------|--|-S-----|-|%----------y--%---S-S@S-g------TT------S-o--o
-------------S-----S--TTTTT-------S---------SSSSSSSSS%----||%--%----o|---------|---|-------|--|----o%-|-----o----S-SX--|---S-S-S----go-gTTg-SSSSSSSSSS
---------------------XXXXXXXXXXX------------SSSSSSSSS----S----S-----%|---%o--%-----|-------|--|--%-%|%|%---SS-SSSS-SS--|o-oS-S-SSSSSSSSSSSSSKSSS-SSS-S
---------------------XXXTXXXXXXX------------SSSSSSSSS--------%------||----%%-|-----|---%---|--|----|||--------SSSS#SX--|SkSSSSS-S-SS--SSSSSSySSS-SSS-S
--------------------------------SSSSSSSSSSSSSS-SSSSS----%----|--------%---||-|-----|%--|---|---------|--------SSSS#SX--|---SS-S-S-SS--SSSSbStSS--k---S
---------------------------------SSSSSSSSSSSS----S-S---------|-------%--%-||%|-----||-%----|--%------|---------SSS#|---|---SS-S-S--S-k--S-TSXXXXXXXXXX
---------------------------------SSSSSSS--SSS----S-S---------|----%-----|%|||%----%-----%%-|%-|------%-----XXXXXXXXX---|----S-|XXXXXXXXXXXXXXXXXXXXXXX
---------------------------------SSSSSSS--SSS--g---S---------|----|-----||||||-o--|--%--|-----|------|-----XXXXXXXXX--%|XXXXXXXXXXXXXXXXXXXX----------
------TTTT----------------------------------SSSSS-SSS--------|%%--------||||||-%--|--|--|------------|---%----------SS||XXXXXXX-----------------------
------TTTT----------------------S-----------SSSSS-S-S-----S-o--------o--||||||%---|--|--|------------|--%|----------S---------------------------------
----tTTTTT------------S--------SS!----g-SS--SSSSS-S-S-------%-----------||||||----|--%--|-----------o|-%||----------S------------------------SSS-S-SSS
----tTTTTT----g-----------------SSSSSSSSSSSSSS--S-S-S-------|---------------------|-%|--|------------|%|||--SSSSSSSSS----------SSSSSSSSSSSSS-SSSSSSSSS
XXXXXXXXXXXXXXXXXXXXX-----------S-SSS--SS-SSSXXXXXXXX-------|----%-------------------|--|%%%---------|-|||--SSSSSS-SS---%SSSSSSSSSSSSSSSSSSSoSSSSSSSSS
XXXXXXXXXXXXXXXXXXXXX----------kS-SSS--S--SSSXXXXXXXX---%---|------------------------|%%|%||--S--------|||---SSSSSgSS----S-S-SSSSSSSSSSSS-SSSSSSS-SSSS
