------------------------------------------------------------------------------------------------------------------------------------------------------------------------------------------------------------------------------
------------------------------------------------------------------------------------------------------------------------------------------------------------------------------------------------------------------------------
------------------------------------------------------------------------------------------------------------------------------------------------------------------------------------------------------------------------------
------------------------------------------------------------------------------------------------------------------------------------------------------------------------------------------------------------------------------
------------------------------------------------------------------------------------------------------------------------------------------------------------------------------------------------------------------------------
-------------------------------------------------------------------------------------------------------------------------------------------------------------------------------------------------------------------##---------
------------------------------------------SUS----------------------------------------------------------------------------------------------------------------------------------------------------------------------##---------
----------------------------------------------------------------------------------------------------------------------------------------------------------------------------------TT-------------------------------##---------
------------------------------------------------------------------------------------------------------------------------------------------o---------------------------------------TT------------------------K---#--##---------
-------------------------------------------------------------------------------------------------------------TT----------------------------------------------------------#LSS-----##---------------------------##--##---------
-----------------------------------------#####---------------------------------------------------------------TT----------------------------------------------------------#------------------------------------###--##---------
-------K---------------------------------#--------------------------#----------------------------------------TT----------------------------------------------------------#-----------*---TT-----*------------####------------F
----------------------------------------K#---------------------*----#-----------------------------X------ggg-TT----k-k---------------k---------ggg-------ggg-----------kk#-----------*---TT-----*-----K-----#####------------#
--M-----------ggg-------ggg--------------#--------------ggg----*----#----ggg--k----ggg------------XXXXXXXXXXXXXXXXXXXXXX-X-XX-XX-XX-XXXXXXXXXXXXXXXXXXXXXXXXXXXXXXXXXXXXXXXXXX---XXXXXXXXXXXXXXXXXXXXXXXXXXXXXXXXXXXXXXXXXXXXX
XXXXXXXXXXXXXXXXXXXXXXXXXXXXXXXXXXXXXXXXXXXX----XXXXXXXXXXXXXXXXXX--XXXXXXXXXXXXXXXXXXXXXXXXXXXXXXXXXXXXXXXXXXXXXXXXXXXX-X-XX-XX-XX-XXXXXXXXXXXXXXXXXXXXXXXXXXXXXXXXXXXXXXXXXX---XXXXXXXXXXXXXXXXXXXXXXXXXXXXXXXXXXXXXXXXXXXXX
XXXXXXXXXXXXXXXXXXXXXXXXXXXXXXXXXXXXXXXXXXXX----XXXXXXXXXXXXXXXXXX--XXXXXXXXXXXXXXXXXXXXXXXXXXXXXXX---------------------------------------------------------------------------------------------------------------------------
