--------XXXXXXXXXXXXXXXXXXXXXXXXXXXXXXX-----#--T------------#------------ST#-S---@S!S---#--------------------------------------------------------XXXXX
--------XXXXXXXXXXXXXXXXXXXXXXXXXXXXXXX-----#--T----g--S----#-k-----------T#------------#-------------------------------------------------------------
----------------------------------------XXXXXXXXXXXXXXXXXXXXXXXXXXXXXXXX--T#------------#-------------------------------------------------------------
----------------------------------------XXXXXXXXXXXXXXXXXXXXXXXXXXXXXXXX--T#----------g-#-------------------------------------------------------------
-------------------------------------------------------------------------XXXXXXXXXXXXXXXX-------------------------------------------------------------
-------------------------------------------------------------------------XXXXXXXXXXXXXXXX-----------------US-------------L-----S@-----SS------S-------
-------------------------------------------------------------------------------------------------------------------------#----------------------------
-----------------------------#-------------------------------------------------------------------------------------------#--------------#---------S---
--------S---U--S-------------#-----k--------------------------------------------------------T-------T-----------g--------#--------------#-------------
------------------------------------------------------------------------------------------!#TT------T--T------S-#-----!--#--------------#-------------
-------S----------------------------------S--------!S----S----!-S------------------------#-#TT------T--T--------#--------#--------------#--t---------#
--------------T--------------------------------------------------------------------------#-#TT------T--T--------#--------#----#---------#--t-------S-#
----------S-TUT---------#-S-------#----S---t---------------------------------S-----------#-#TT-#g---T--T--------#------k-#S---#--g------##-t---------#
------------T-T-------T-#---------#------------------------------------------------------#XXXXXXXXXXXXXXXXXXXXXXXXXXXXXXXXXXXXXXXXXXXXXXXXXXXXXXX----#
XXXXXXXX----T-T-------T-#--#------#---------S#---------------#!U----St-------------------#XXXXXXXXXXXXXXXXXXXXXXXXXXXXXXXXXXXXXXXXXXXXXXXXXXXXXXX-g--#
XXXXXXXX----T-T----k--T-#--#------#----------#--T------------#---------------------------#--------------------------------------------------------XXXX
