------------------------------------------------------------------------------------------------------------------------------------------------------
---------------------------------g--------------------------------------------------------------------------------------------------------------------
------S-----------------------------------------------------------------------------------------------------------------------------------------------
------------------------------------------------------------------------------------------------------------------------------------------------------
-------------------------------------------------------------------------------------S-----------------------------------------------------------@----
---------------------------------------------------------------------------------------------------------------------------------------------------S--
----S!------S-SS--S--S-!S-!-S-!S---!-S--!-!!SS-S-S-!-----S-SSS-SS-----S------S-S!-S-S!S!-----S-@S-S------S--S-SS----S-S-S----S!----St-SSS-S--------SS-
----------------------------------------------------------------------------------------S-------------------------------------------X----S------------
------------------------------------------------------------------------------------------------------------------------------------X-----------------
-----S--S----------------------------------------SS-----------------------------------------------------------------------------S---!-----------------
----S-S!--S-!S-!!S--!-SS-!S!-!!-S-S!!-!-!-!SS-S-S-!S!-SS-S-St----SSSS-!-S-!-SS---U--!-SS!SS!!---S!--!-!--S--!S---SSSS-S-SS--!SC!!!1@-SSSSS!@SS!!S--S#@
-----------!---------S--!-----------U--t-------------------St-----------------!--------!-------t----------t-------@----S--------@---@---------------#-
---------------------------------------t--------------------t---#------#--------t--------------#--t-------t----------#----#--------F----#-----------#-
--------------------S------------------t----------g-------##t-#-#----gg#--------t--------------#--t-#-----t----X-----##---#--------##---#-----------#-
XXXXX-XXXXX-XXX-XXXXXXXXXXXXXXXXXXXX-XXXXXXX-XXXXXXXX-XXX-XXXXXXXXXXXXXXXXXXXXXXXXXXXXXXXXX-XXXXX-XXXXXXXXXX--XXX-XXXXXXXXXX-XXX-XXXXXXXXXXXXXXXXXXXXX
XXXXX-XXXXX-XXX-XXXXXXXXXXXXXXXXXXXX-XXXXXXX-XXXXXXXX-XXX-XXXXXXXXXXXXXXXXXXXXXXXXXXXXXXXXX-XXXXX-XXXXSXXXXX--X-X-XXXXXXXXXX-XXX-XXXXXXXXXXXXXXXXXXXXX
